"","C>A","C>G","C>T","T>A","T>C","T>G","C>T at CpG","C>T other"
"A1_1001000295",2689,2448,9768,3149,8450,2197,2355,7413
"A1_B000860",333,257,1743,218,758,173,448,1295
"A1_B000863",1667,1392,9517,1363,6560,979,2388,7129
"A1_B000883",72,40,384,40,204,25,98,286
"A1_B001007",550,492,2113,485,1932,464,653,1460
"A1_B001464",2147,1950,12829,2236,9964,1669,3014,9815
"A1_B001474",1665,1529,6685,1574,6595,1322,1896,4789
"A1_B001543",1873,1627,10459,1522,6503,1133,2602,7857
"A1_B001551",199,104,574,110,724,158,135,439
"A1_B001558",2114,1954,11986,1905,8573,1510,3084,8902
"A1_B001559",1081,1049,6096,1126,5585,743,1378,4718
"A1_B002568",1250,1211,7219,988,5567,1055,1999,5220
"A1_B002571",20,22,112,24,65,10,24,88
"A1_B002572",2526,2528,15564,2364,10985,1832,4017,11547
"A1_B003067",855,813,5176,777,5666,635,1357,3819
"A1_B003115",497,431,2035,470,2497,434,595,1440
"A1_B003121",165,116,615,125,377,94,160,455
"A1_B003129",407,354,1516,365,1664,260,403,1113
"A1_B003132",600,457,3118,504,1669,331,761,2357
"A1_B003191",1942,2061,10049,1896,7730,1443,2721,7328
"A1_B003523",8840,11657,44346,8100,51622,7961,13535,30811
"A1_B003528",5,2,27,1,20,4,5,22
"A1_B003642",789,648,4436,620,2810,446,1145,3291
"A1_B003646",472,366,2460,399,1719,312,614,1846
"A1_B003648",998,866,5579,913,3489,627,1349,4230
"A10_1001000407",381,469,2047,304,1195,280,597,1450
"A10_1001000408",1276,1341,6643,1124,5930,991,1924,4719
"A10_1001000412",1525,1613,8206,1325,7752,1191,2309,5897
"A10_B000863",185,137,887,107,369,95,212,675
"A10_B001007",583,524,1951,516,1784,435,621,1330
"A10_B001470",820,795,4209,834,3802,679,1059,3150
"A10_B001474",897,825,3949,790,3386,671,1023,2926
"A10_B001545",1259,1170,7442,1233,5156,874,1834,5608
"A10_B001548",1281,1223,6986,1202,5540,902,1863,5123
"A10_B001554",929,863,5057,863,4686,696,1368,3689
"A10_B001558",589,576,3129,623,3247,483,805,2324
"A10_B002572",5273,5680,26486,4824,23573,4140,7363,19123
"A10_B003070",1270,1188,7098,1175,7616,934,1835,5263
"A10_B003071",486,461,2872,461,3227,370,709,2163
"A10_B003115",191,150,842,150,666,119,197,645
"A10_B003125",815,655,3713,704,2783,500,951,2762
"A10_B003518",1948,1925,10179,1919,9956,1472,2759,7420
"A10_B003523",1252,1094,5886,1021,3516,771,1531,4355
"A10_B003527",935,729,4960,621,2669,483,1258,3702
"A10_B003528",1297,1084,6067,1100,3870,809,1580,4487
"A10_B003529",1884,1916,9609,1915,8171,1567,2526,7083
"A10_B003588",3368,3262,15749,2709,16278,2274,4567,11182
"A11_1001000318",122,84,368,59,265,75,112,256
"A11_1001000407",1441,1576,7559,1218,6421,1106,2090,5469
"A11_1001000408",1202,1266,6062,986,5557,890,1701,4361
"A11_1001000412",1453,1500,7773,1201,6852,1110,2178,5595
"A11_B000860",141,103,703,95,358,67,168,535
"A11_B000861",1092,651,4666,726,3679,521,1134,3532
"A11_B000862",4003,3546,20386,3403,16730,2790,5368,15018
"A11_B001007",862,581,2507,592,2308,605,771,1736
"A11_B001470",1046,976,5318,1048,4018,764,1353,3965
"A11_B001474",407,372,1940,373,938,289,436,1504
"A11_B001475",430,378,2462,411,1553,296,626,1836
"A11_B001545",315,294,1565,314,1736,288,363,1202
"A11_B001551",937,928,4498,936,5596,746,1158,3340
"A11_B001554",591,552,3430,561,2682,465,894,2536
"A11_B001558",1672,1564,9485,1644,6653,1309,2397,7088
"A11_B002077",3167,3076,15501,2743,13490,2409,4441,11060
"A11_B002079",2130,2039,10502,2009,10431,1618,2860,7642
"A11_B002572",2953,2816,18522,2967,12724,2088,4770,13752
"A11_B002573",74,74,536,71,226,47,159,377
"A11_B003067",889,784,4345,843,5615,658,1102,3243
"A11_B003115",462,404,1920,432,1961,402,444,1476
"A11_B003119",1365,1150,6843,1207,4722,846,1615,5228
"A11_B003518",2351,2293,12633,2248,10874,1727,3414,9219
"A11_B003522",980,892,5152,830,2711,617,1318,3834
"A11_B003523",730,611,3498,633,1919,442,923,2575
"A11_B003527",1563,1220,8248,1307,6314,972,2102,6146
"A11_B003528",1439,1087,7467,1195,4791,924,1757,5710
"A11_B003577",934,680,3482,723,2703,513,839,2643
"A12_1001000317",683,792,3371,500,2725,507,1041,2330
"A12_1001000407",1873,2149,10316,1699,9659,1476,2859,7457
"A12_1001000408",576,670,3147,478,2709,458,954,2193
"A12_1001000412",1833,1899,10260,1666,11040,1436,2919,7341
"A12_B001010",1408,1104,7061,1231,5633,813,1786,5275
"A12_B002077",2709,3065,14516,2624,12775,2244,4043,10473
"A12_B002078",1509,1189,7705,1301,5615,945,1852,5853
"A12_B002572",1636,1388,8019,1523,6222,1214,2108,5911
"A12_B003070",1615,1600,10024,1598,8693,1172,2537,7487
"A12_B003103",463,418,2288,394,1251,271,569,1719
"A12_B003105",1051,961,6204,1046,4598,792,1449,4755
"A12_B003116",2474,2466,12112,2233,9666,1888,3339,8773
"A12_B003119",1445,1333,8021,1369,5986,1034,2178,5843
"A12_B003518",1505,1461,8233,1568,6382,1137,2127,6106
"A12_B003527",1678,1396,8845,1523,7971,1088,2375,6470
"A12_B003528",567,499,2870,470,1556,334,677,2193
"A12_B003529",1716,1669,8732,1601,6777,1347,2317,6415
"A12_B003776",938,828,5260,927,4251,979,1239,4021
"A13_1001000340",483,483,1717,505,2559,441,439,1278
"A13_1001000407",1935,2083,10288,1606,9803,1398,2943,7345
"A13_1001000408",872,864,4170,723,3990,620,1174,2996
"A13_1001000412",1300,1470,6681,1029,6586,966,1909,4772
"A13_B000420",351,323,1497,280,1433,237,365,1132
"A13_B001010",669,614,2716,595,2160,445,731,1985
"A13_B002077",934,826,4535,853,3778,658,1230,3305
"A13_B002079",951,865,4920,941,4359,643,1324,3596
"A13_B002572",2715,2705,17274,2534,11997,1970,4578,12696
"A13_B003103",2000,1875,9679,1698,7179,1376,2525,7154
"A13_B003112",839,763,3782,769,3645,640,977,2805
"A13_B003116",1702,1767,8126,1700,7001,1274,2265,5861
"A13_B003120",419,264,2009,291,1146,224,486,1523
"A13_B003518",1348,1271,6563,1277,5947,951,1702,4861
"A13_B003522",1836,1815,10022,1794,7631,1307,2707,7315
"A13_B003527",1220,1197,6458,1149,9036,966,1740,4718
"A13_B003528",339,212,1997,269,1163,167,509,1488
"A13_B003529",2528,2638,12051,2278,10233,1906,3308,8743
"A13_B003771",1805,1739,9382,1721,7565,1401,2437,6945
"A13_B003777",1228,1292,5987,1173,6258,1009,1644,4343
"A13_B003894",439,384,1848,409,1099,280,455,1393
"A14_1001000339",1241,1179,5198,1228,5212,907,1358,3840
"A14_1001000340",532,510,2210,539,2657,420,600,1610
"A14_1001000407",1723,1862,9653,1508,8353,1288,2723,6930
"A14_1001000408",1164,1233,6088,971,5533,841,1717,4371
"A14_1001000412",1502,1567,8137,1297,7601,1129,2314,5823
"A14_B000422",2741,2689,14301,2773,11390,2088,3760,10541
"A14_B001016",292,253,1613,243,1428,182,375,1238
"A14_B001557",1235,1096,6319,1297,5811,895,1587,4732
"A14_B002073",618,586,3815,565,2496,455,937,2878
"A14_B002074",739,647,3271,601,2673,524,881,2390
"A14_B002077",264,205,1277,222,604,148,318,959
"A14_B002078",331,259,1833,290,1765,223,463,1370
"A14_B002079",1998,1802,10040,1890,10075,1454,2607,7433
"A14_B002097",738,655,3626,533,2921,405,942,2684
"A14_B002572",2146,2085,11060,1923,8614,1563,3051,8009
"A14_B003067",87,95,616,76,398,58,168,448
"A14_B003103",2854,2891,14192,2754,13207,2118,3726,10466
"A14_B003105",365,367,2370,316,1085,221,580,1790
"A14_B003112",1699,1733,8144,1598,7274,1235,2175,5969
"A14_B003120",1046,677,5491,758,3450,542,1247,4244
"A14_B003125",353,200,1743,223,1137,175,416,1327
"A14_B003126",129,114,853,93,373,70,197,656
"A14_B003129",399,355,1935,390,1023,246,454,1481
"A14_B003132",896,784,4557,786,2972,606,1160,3397
"A14_B003187",1034,953,4477,942,3759,674,1211,3266
"A14_B003191",628,648,3371,650,2594,504,837,2534
"A14_B003518",1618,1598,8430,1592,6869,1185,2234,6196
"A14_B003527",1992,1483,9175,1473,9117,1060,2305,6870
"A14_B003528",614,517,3224,602,2310,409,764,2460
"A14_B003529",1191,1057,6056,1095,4344,821,1599,4457
"A14_B003588",349,232,1334,231,1461,212,377,957
"A14_B003771",671,605,3555,635,2895,464,903,2652
"A14_B003775",352,296,1853,283,2020,299,480,1373
"A14_B003776",432,349,2519,388,1172,226,609,1910
"A14_B003777",4589,5106,23029,4174,22151,3837,6668,16361
"A14_B003920",165,132,688,135,439,97,185,503
"A14_B003930",2271,2301,10929,2011,8731,1688,3034,7895
"A15_1001000340",876,813,3365,732,3263,606,842,2523
"A15_1001000407",1733,1821,9037,1437,8550,1265,2557,6480
"A15_1001000408",328,418,2062,222,1426,250,649,1413
"A15_1001000412",1483,1616,7949,1370,9027,1167,2216,5733
"A15_B000420",85,83,313,59,273,56,69,244
"A15_B000422",401,274,1662,380,1595,276,410,1252
"A15_B001010",1287,1071,7334,1194,6065,863,1793,5541
"A15_B001557",750,712,3874,831,3368,645,983,2891
"A15_B002073",289,224,1281,152,597,116,344,937
"A15_B002074",1520,1554,7153,1354,5906,1146,2018,5135
"A15_B002077",2474,2535,12736,2297,11005,1921,3613,9123
"A15_B002078",1771,1384,9215,1550,6596,1185,2281,6934
"A15_B002079",2430,2218,12109,2353,10568,1679,3198,8911
"A15_B003070",788,761,4627,786,4738,610,1178,3449
"A15_B003071",565,536,3034,503,2881,384,780,2254
"A15_B003105",588,504,3660,491,1826,330,860,2800
"A15_B003112",1313,1290,6186,1170,5902,976,1700,4486
"A15_B003116",3406,3271,15768,3076,13289,2461,4371,11397
"A15_B003125",529,446,2595,428,1989,319,625,1970
"A15_B003126",388,358,1948,343,1480,234,493,1455
"A15_B003129",2842,2929,13312,2532,12325,2212,3778,9534
"A15_B003132",704,516,3590,627,1905,477,799,2791
"A15_B003187",925,880,4245,826,3537,691,1121,3124
"A15_B003191",685,592,3650,587,1861,428,879,2771
"A15_B003518",2036,2033,10632,2027,9270,1566,2878,7754
"A15_B003522",840,778,4325,667,2145,495,1146,3179
"A15_B003527",2250,1812,11584,1807,9406,1390,3003,8581
"A15_B003528",698,529,3544,576,2506,432,842,2702
"A15_B003529",3618,4131,17423,3562,17547,3131,5096,12327
"A15_B003771",633,392,3306,446,1591,278,742,2564
"A15_B003776",2951,2804,14992,2671,12248,1935,3905,11087
"A15_B003894",6651,7720,31521,6097,31168,5498,9482,22039
"A15_B003920",1985,2071,10043,1952,9401,1594,2852,7191
"A15_B003930",142,115,684,120,427,57,161,523
"A16_1001000339",1548,1421,5807,1329,6014,1186,1489,4318
"A16_1001000407",1886,2010,9906,1554,9069,1321,2687,7219
"A16_1001000408",575,605,2992,441,2475,416,879,2113
"A16_1001000412",1531,1585,7901,1319,7512,1096,2196,5705
"A16_B000420",874,868,3704,777,4379,684,1091,2613
"A16_B001007",394,344,1299,381,1259,373,393,906
"A16_B001008",1115,1036,6236,1078,4928,791,1582,4654
"A16_B001010",1296,1100,7142,1254,5992,966,1744,5398
"A16_B002073",1274,1077,7406,1104,5160,836,1859,5547
"A16_B002074",687,703,3368,677,3237,502,885,2483
"A16_B002077",1609,1653,7879,1466,6769,1206,2176,5703
"A16_B002572",2353,2445,15937,2169,9649,1669,4190,11747
"A16_B003071",430,386,2206,376,1694,322,578,1628
"A16_B003112",534,592,2656,550,2312,428,744,1912
"A16_B003116",2535,2450,10230,2181,9737,1831,2811,7419
"A16_B003120",610,397,3002,476,2348,376,700,2302
"A16_B003125",265,163,1230,177,856,134,293,937
"A16_B003126",268,232,1244,250,1293,174,323,921
"A16_B003129",855,789,3958,776,3204,659,1041,2917
"A16_B003132",923,665,4363,765,2927,621,1098,3265
"A16_B003187",72,64,323,57,202,48,68,255
"A16_B003191",873,831,4312,836,4489,670,1160,3152
"A16_B003518",1384,1297,7282,1285,5213,903,1871,5411
"A16_B003527",1017,815,5940,832,3233,549,1577,4363
"A16_B003528",706,573,3665,606,2309,454,858,2807
"A16_B003654",1414,1155,6837,1253,5387,991,1757,5080
"A16_B003771",534,441,2778,480,2092,389,619,2159
"A16_B003775",361,294,1646,338,1332,260,382,1264
"A16_B003776",213,124,882,156,422,102,210,672
"A16_B003777",362,323,1716,318,1427,303,451,1265
"A16_B003894",1487,1416,6549,1286,5715,1024,1774,4775
"A16_B003920",1114,1054,5019,1057,5388,800,1299,3720
"A16_B003930",1703,1638,8035,1521,5947,1243,2096,5939
"A16_B003995",1049,837,6123,928,3176,624,1482,4641
"A17_1001000339",1386,1370,5548,1282,5824,1071,1448,4100
"A17_1001000407",2031,2063,10430,1754,9641,1483,2852,7578
"A17_1001000408",1137,1248,6059,971,5708,893,1702,4357
"A17_1001000412",1321,1467,6800,1191,6524,1011,1905,4895
"A17_B000420",1114,1014,4841,907,4459,771,1191,3650
"A17_B000422",2343,2197,11114,2178,10324,1759,2945,8169
"A17_B001010",1438,1259,8011,1404,6567,998,1922,6089
"A17_B001016",1116,896,6357,1045,3999,779,1590,4767
"A17_B002073",67,53,424,54,203,38,94,330
"A17_B002077",707,502,3069,474,1372,388,714,2355
"A17_B002079",1001,812,4884,905,3598,648,1243,3641
"A17_B002097",192,145,1044,141,643,118,258,786
"A17_B003070",688,695,4175,625,3384,460,1066,3109
"A17_B003079",921,679,4428,728,3591,634,992,3436
"A17_B003103",2397,2084,11247,2061,8455,1518,2990,8257
"A17_B003105",418,356,2735,422,1447,293,653,2082
"A17_B003112",1251,1352,6048,1150,5908,1015,1729,4319
"A17_B003116",1514,1527,6912,1353,5538,1137,1878,5034
"A17_B003120",355,234,1866,265,1358,199,450,1416
"A17_B003518",700,674,3468,667,2932,433,873,2595
"A17_B003528",589,475,2860,579,2006,421,711,2149
"A17_B003654",282,198,1519,225,905,162,357,1162
"A17_B003771",291,191,1661,205,649,122,426,1235
"A17_B003775",437,380,2555,396,1996,319,640,1915
"A17_B003776",1909,1799,10652,1772,8002,1301,2711,7941
"A17_B003777",718,574,3723,545,1685,388,928,2795
"A17_B003894",1268,1122,5712,1073,5314,911,1554,4158
"A17_B003920",1795,1750,8128,1743,8773,1336,2292,5836
"A18_1001000407",2043,2190,10949,1686,10010,1595,3136,7813
"A18_1001000408",1125,1191,5604,968,5498,837,1589,4015
"A18_B000420",1571,1414,6186,1391,6016,1098,1685,4501
"A18_B000422",1956,1915,10256,1878,7871,1446,2662,7594
"A18_B001007",606,557,2271,590,2218,540,727,1544
"A18_B001010",1240,963,6595,1107,5375,762,1692,4903
"A18_B002074",1273,1248,6895,1106,5501,830,1949,4946
"A18_B002078",1462,1321,8302,1324,6474,964,2208,6094
"A18_B002079",621,520,3237,563,3412,444,812,2425
"A18_B002572",2490,2480,16305,2396,11344,1743,4256,12049
"A18_B003103",3489,3743,18467,3158,14825,2721,5212,13255
"A18_B003112",2528,2626,11854,2344,11535,1936,3442,8412
"A18_B003116",2869,3033,13002,2636,11192,2190,3813,9189
"A18_B003120",1067,716,5194,757,3508,577,1238,3956
"A18_B003518",1844,2069,9773,1784,8680,1349,2676,7097
"A18_B003522",1028,1105,5107,1065,6460,904,1424,3683
"A18_B003527",948,672,4812,692,3622,503,1266,3546
"A18_B003528",1007,797,5293,880,3657,634,1255,4038
"A18_B003588",2208,1913,10527,1773,10921,1449,2777,7750
"A18_B003654",263,184,1210,168,878,146,317,893
"A18_B003771",3324,3221,17255,3172,15189,2566,4431,12824
"A18_B003775",1030,922,6139,996,4239,779,1503,4636
"A18_B003776",1916,1795,10546,1864,8898,1453,2702,7844
"A18_B003777",3261,3538,14682,3150,13490,2662,4219,10463
"A18_B003920",1498,1312,6866,1263,5836,1029,1822,5044
"A18_B003995",158,116,720,113,407,98,201,519
"A19_1001000340",685,693,2683,676,2941,532,654,2029
"A19_1001000407",1938,1954,9860,1600,9479,1448,2814,7046
"A19_1001000408",1342,1432,6931,1169,7021,1081,2023,4908
"A19_1001000412",1816,1960,9528,1554,10013,1377,2689,6839
"A19_B000420",1041,1005,4315,866,4042,798,1149,3166
"A19_B000422",2873,2686,14146,2696,10916,2030,3665,10481
"A19_B002074",611,569,3510,446,1611,367,940,2570
"A19_B002077",1468,1299,7682,1384,5539,1054,2168,5514
"A19_B002078",1768,1581,9320,1505,6713,1164,2387,6933
"A19_B002097",450,425,2275,375,1912,275,563,1712
"A19_B002572",1577,1570,9454,1438,5803,1123,2535,6919
"A19_B003070",438,416,2052,458,2967,346,515,1537
"A19_B003078",1166,935,3836,779,3640,747,1298,2538
"A19_B003112",324,316,1282,305,1380,198,348,934
"A19_B003116",188,113,743,150,358,86,148,595
"A19_B003120",393,284,1748,313,1647,219,419,1329
"A19_B003518",1494,1390,7962,1378,5714,1023,2034,5928
"A19_B003522",1275,1157,6014,1132,5444,913,1594,4420
"A19_B003527",1127,893,5658,851,3889,578,1413,4245
"A19_B003528",725,518,3282,629,2237,464,756,2526
"A19_B003588",2326,1886,10386,1573,7864,1321,2869,7517
"A19_B003654",225,188,1178,191,773,138,326,852
"A19_B003771",1549,1252,8181,1395,5803,1037,2031,6150
"A19_B003776",2048,1804,10794,1861,8633,1385,2856,7938
"A19_B003777",332,227,1275,250,938,189,312,963
"A19_B003894",941,810,4115,772,3107,592,1070,3045
"A19_B003920",3786,3938,18777,3530,15895,2878,5423,13354
"A19_B003930",1425,1299,7005,1181,4928,917,1798,5207
"A19_B003995",1087,844,6369,1056,4852,661,1486,4883
"A2_1001000408",771,869,4064,649,3383,615,1197,2867
"A2_1001000411",1407,1510,7395,1178,6542,1065,2105,5290
"A2_1001000412",80,96,341,74,255,59,99,242
"A2_B000862",1247,1047,6181,1141,4706,769,1498,4683
"A2_B001470",759,663,3898,740,2940,566,988,2910
"A2_B001543",2261,1900,11778,1853,7843,1358,2955,8823
"A2_B001557",600,610,3026,712,3722,587,723,2303
"A2_B001558",941,938,5278,888,4110,798,1400,3878
"A2_B002572",1561,1292,8835,1150,3956,870,2227,6608
"A2_B003067",1282,1259,7672,1285,6569,929,1997,5675
"A2_B003115",295,264,1252,233,1054,223,306,946
"A2_B003129",762,761,3353,741,3147,605,931,2422
"A2_B003132",1011,792,5332,849,2759,628,1260,4072
"A2_B003191",282,324,1650,292,1219,246,430,1220
"A2_B003659",445,336,2357,350,1418,270,567,1790
"A20_1001000339",1651,1585,6354,1594,6286,1149,1602,4752
"A20_1001000407",1667,1905,9520,1535,8544,1339,2678,6842
"A20_1001000408",988,1188,5596,885,4636,793,1616,3980
"A20_1001000412",1492,1691,8155,1313,7991,1189,2312,5843
"A20_B000420",1077,955,3731,811,3998,683,1096,2635
"A20_B000422",2120,2021,10783,2035,7592,1522,2729,8054
"A20_B000901",430,346,1384,322,1286,311,466,918
"A20_B001008",1080,919,5587,971,4887,777,1313,4274
"A20_B001010",782,773,4355,835,4043,551,1056,3299
"A20_B002073",652,621,3905,539,3026,452,1035,2870
"A20_B002074",1129,1041,5676,970,4585,873,1496,4180
"A20_B002078",877,717,4218,712,3455,589,1089,3129
"A20_B002079",2377,2108,12001,1969,8822,1557,3225,8776
"A20_B002572",1979,2025,13208,1767,8125,1324,3380,9828
"A20_B003105",93,89,652,102,395,72,162,490
"A20_B003112",1576,1730,7686,1394,7277,1215,2289,5397
"A20_B003116",2263,2385,9834,2081,8727,1754,2858,6976
"A20_B003120",1011,751,4893,749,3615,648,1236,3657
"A20_B003518",1528,1466,8004,1404,5511,1016,2091,5913
"A20_B003527",1039,809,5110,820,4021,639,1311,3799
"A20_B003528",690,526,3615,618,2466,426,840,2775
"A20_B003588",1794,1633,8926,1513,8725,1183,2471,6455
"A20_B003771",1535,1267,7825,1366,6062,1024,1895,5930
"A20_B003777",1937,2009,10239,1865,8712,1507,2826,7413
"A20_B003894",220,152,986,180,470,98,238,748
"A20_B003920",194,172,961,191,456,107,204,757
"A21_1001000407",1298,1394,6996,1139,6277,998,2006,4990
"A21_1001000408",1276,1353,6558,1033,6298,976,1853,4705
"A21_1001000412",1577,1715,8526,1435,8171,1217,2416,6110
"A21_B000420",1113,1001,4032,891,4012,733,1158,2874
"A21_B000422",3787,4206,19261,3507,20407,3239,5782,13479
"A21_B000883",827,674,2520,583,2594,621,882,1638
"A21_B000901",478,443,1625,365,1516,362,544,1081
"A21_B001007",550,478,1689,467,1675,414,529,1160
"A21_B001008",295,246,1475,254,1222,173,385,1090
"A21_B001016",1251,1018,6383,1050,4461,735,1607,4776
"A21_B002073",851,710,4623,685,3121,578,1131,3492
"A21_B002074",133,94,520,115,426,80,172,348
"A21_B002078",405,417,2161,402,3124,299,582,1579
"A21_B002079",905,695,4373,630,1854,408,1096,3277
"A21_B002572",1823,1902,10226,1426,7137,1248,2832,7394
"A21_B003093",1506,1532,6731,1263,5680,1007,1817,4914
"A21_B003103",2957,2681,14913,2535,11060,1927,3914,10999
"A21_B003105",753,592,5195,683,2547,456,1189,4006
"A21_B003112",2182,2216,10457,2033,9518,1641,2968,7489
"A21_B003116",830,769,3037,666,2789,528,832,2205
"A21_B003120",890,662,4586,720,3220,499,1068,3518
"A21_B003187",157,120,674,119,458,99,199,475
"A21_B003518",1898,1854,9300,1746,8547,1315,2535,6765
"A21_B003522",1224,1122,6612,1102,4659,812,1731,4881
"A21_B003527",928,769,4248,813,3928,529,1062,3186
"A21_B003528",423,336,1990,373,1357,270,454,1536
"A21_B003654",549,385,2444,485,1850,360,544,1900
"A21_B003658",46,54,373,33,219,29,98,275
"A21_B003771",1011,748,4892,832,3714,616,1192,3700
"A21_B003775",964,934,5680,887,3530,607,1442,4238
"A21_B003777",2447,2549,12226,2395,12658,1975,3500,8726
"A21_B003894",421,294,1601,340,1591,230,438,1163
"A21_B003920",1488,1431,6979,1354,5999,1052,1943,5036
"A21_B003995",2721,2202,14349,2405,10688,1724,3610,10739
"A22_1001000407",1818,2019,9759,1560,9107,1354,2783,6976
"A22_1001000408",1208,1259,6113,1028,5221,886,1709,4404
"A22_B000420",492,420,1882,389,1780,343,573,1309
"A22_B000883",958,854,3261,723,3102,747,1102,2159
"A22_B000901",888,534,2155,489,2033,507,743,1412
"A22_B001007",555,446,1667,429,1657,385,505,1162
"A22_B001008",466,353,2468,420,1712,328,540,1928
"A22_B001010",988,893,5067,981,4479,746,1309,3758
"A22_B002073",641,508,3237,460,2654,359,823,2414
"A22_B002074",155,116,498,105,468,117,142,356
"A22_B002077",222,151,940,198,423,113,237,703
"A22_B002079",399,337,2169,317,1030,208,569,1600
"A22_B002097",665,562,3216,525,2608,436,805,2411
"A22_B003067",395,340,1858,314,1417,264,473,1385
"A22_B003071",196,211,833,155,741,148,216,617
"A22_B003080",480,400,2296,378,1645,313,563,1733
"A22_B003105",377,349,2234,376,1629,260,540,1694
"A22_B003112",345,285,1602,242,717,182,425,1177
"A22_B003116",2012,2061,8660,1821,7934,1499,2536,6124
"A22_B003129",528,465,2294,447,1812,347,602,1692
"A22_B003132",491,256,1617,255,948,178,424,1193
"A22_B003191",1326,1209,6258,1110,5137,925,1744,4514
"A22_B003518",1152,1252,6068,1114,6280,924,1754,4314
"A22_B003522",1701,1477,8098,1327,4324,924,2165,5933
"A22_B003527",457,448,2195,411,2182,297,611,1584
"A22_B003646",209,174,1100,165,619,127,268,832
"A22_B003771",1324,985,7587,1157,5095,758,1850,5737
"A22_B003775",46,42,236,39,227,46,70,166
"A22_B003776",1117,959,4995,989,5731,735,1366,3629
"A22_B003777",5001,5447,25775,4665,21482,4053,7697,18078
"A22_B003920",370,328,1695,371,1734,288,460,1235
"A22_B003995",1582,1608,8515,1296,6539,1120,2117,6398
"A3_1001000408",461,459,2191,410,2374,394,629,1562
"A3_1001000412",1765,1935,9041,1480,8543,1352,2667,6374
"A3_B000862",116,120,613,119,329,71,185,428
"A3_B001007",546,531,1963,538,1884,484,639,1324
"A3_B001464",1064,941,5887,1151,6589,879,1421,4466
"A3_B001470",1822,1693,9461,1794,7015,1392,2492,6969
"A3_B001554",81,74,335,39,173,47,101,234
"A3_B001558",1456,1466,8512,1466,6545,1150,2069,6443
"A3_B002572",581,468,2581,533,2426,427,718,1863
"A3_B002573",220,193,1229,182,623,153,291,938
"A3_B003067",1750,1749,9954,1670,9576,1347,2558,7396
"A3_B003070",944,900,5372,1058,5334,854,1322,4050
"A3_B003115",410,339,1645,309,1366,383,421,1224
"A3_B003129",1198,1245,5579,1151,3910,918,1520,4059
"A3_B003132",657,613,3080,625,1851,443,701,2379
"A3_B003187",111,89,475,89,233,49,110,365
"A3_B003191",1784,1971,8824,1698,7383,1436,2514,6310
"A3_B003528",53,65,242,63,251,46,70,172
"A3_B003659",1534,1381,8059,1307,7566,1006,2024,6035
"A4_10001000325",661,654,3009,499,2692,550,889,2120
"A4_1001000317",772,803,3865,617,2984,625,1165,2700
"A4_1001000407",1775,1865,9679,1496,8820,1255,2719,6960
"A4_1001000411",1288,1405,6963,1068,6309,1013,2021,4942
"A4_B000861",103,113,461,81,412,84,138,323
"A4_B000862",1302,1000,6227,961,3271,705,1551,4676
"A4_B001464",1480,1376,8096,1595,9035,1239,1936,6160
"A4_B001470",1762,1617,9023,1723,6375,1344,2286,6737
"A4_B001551",913,898,4241,839,4486,672,1085,3156
"A4_B001554",258,327,1564,214,1374,196,481,1083
"A4_B001558",1062,1033,5748,1052,4253,790,1463,4285
"A4_B002571",860,846,5575,807,3390,617,1453,4122
"A4_B002572",3794,3819,20318,3652,17950,3032,5594,14724
"A4_B003067",714,615,3505,536,3485,447,944,2561
"A4_B003070",1324,1284,8343,1301,7157,1063,2180,6163
"A4_B003071",689,621,3408,697,4444,538,854,2554
"A4_B003126",1355,1147,7298,1185,5551,832,1823,5475
"A4_B003132",881,766,4553,868,2663,607,1043,3510
"A4_B003187",1118,1142,5054,1062,4211,966,1414,3640
"A4_B003191",2127,2533,10983,2074,9557,1862,3098,7885
"A4_B003995",880,788,4296,863,3764,703,1106,3190
"A5_1001000317",863,940,4076,677,3427,729,1251,2825
"A5_1001000407",836,957,4621,682,3094,613,1324,3297
"A5_1001000408",1160,1285,6324,1048,5290,869,1863,4461
"A5_B000862",8677,9048,42684,7680,43936,6949,12307,30377
"A5_B001007",1249,1130,4468,1047,4351,981,1444,3024
"A5_B001474",2648,2501,11853,2499,11215,2119,3398,8455
"A5_B001545",1057,975,6521,1001,4276,775,1602,4919
"A5_B001548",992,1052,5016,942,4275,839,1396,3620
"A5_B001554",1230,1378,7427,961,5587,844,2288,5139
"A5_B001558",42,48,212,37,130,44,49,163
"A5_B002571",1425,1179,7056,1324,5641,1056,1812,5244
"A5_B002572",3252,3084,16699,3329,14395,2612,4433,12266
"A5_B003067",412,372,1849,506,2507,398,464,1385
"A5_B003070",1229,1133,7523,1106,5758,838,1899,5624
"A5_B003129",818,735,3887,765,2567,624,994,2893
"A5_B003132",721,570,3497,600,1746,451,805,2692
"A5_B003187",1024,981,4805,872,4466,777,1314,3491
"A5_B003191",2266,2197,10162,1979,8725,1584,2810,7352
"A5_B003648",1118,842,5970,966,4232,609,1416,4554
"A5_B003995",329,218,976,220,870,224,312,664
"A6_1001000408",603,798,3491,500,2960,537,1032,2459
"A6_1001000412",1567,1647,8291,1386,7905,1187,2345,5946
"A6_B000862",75,40,325,46,154,33,72,253
"A6_B000863",1814,1440,9583,1380,7279,1090,2278,7305
"A6_B001474",4777,4960,24619,4800,20500,3846,6814,17805
"A6_B001475",303,242,1260,219,682,165,342,918
"A6_B001548",163,150,742,149,627,127,199,543
"A6_B001554",642,622,3577,596,3355,473,1065,2512
"A6_B001558",977,887,5272,1017,4726,808,1367,3905
"A6_B002571",528,573,2966,582,2173,410,743,2223
"A6_B002572",2685,2844,13007,2635,11884,2196,3637,9370
"A6_B003093",5944,7310,31213,5494,28592,5004,9210,22003
"A6_B003129",684,562,3186,630,1661,436,761,2425
"A6_B003132",1351,1051,7019,1188,4153,874,1713,5306
"A6_B003187",621,568,2675,554,2160,462,716,1959
"A6_B003191",555,580,3027,518,2251,443,837,2190
"A6_B003527",618,505,3581,557,3098,454,830,2751
"A6_B003528",114,85,340,87,296,47,78,262
"A6_B003648",213,157,1065,181,912,121,208,857
"A6_B003995",206,169,790,160,601,129,228,562
"A7_10001000325",1004,1169,4711,702,3840,715,1413,3298
"A7_1001000407",923,1027,5437,795,3994,699,1477,3960
"A7_1001000408",947,1001,4710,791,4289,730,1365,3345
"A7_1001000412",471,450,1928,469,2881,400,514,1414
"A7_B000862",917,649,4448,787,2415,559,1011,3437
"A7_B001007",557,590,2111,463,2102,445,700,1411
"A7_B001470",1242,1099,6402,1182,4334,886,1563,4839
"A7_B001474",1994,1592,9478,1816,7138,1293,2486,6992
"A7_B001545",552,577,3517,610,2455,513,840,2677
"A7_B001554",1610,1589,9299,1390,7435,1177,2383,6916
"A7_B001556",210,206,1246,218,1135,167,341,905
"A7_B001558",368,372,2006,373,1787,289,529,1477
"A7_B002571",1242,1259,6782,1282,6708,1097,1707,5075
"A7_B002572",2239,2196,14016,2157,9432,1666,3602,10414
"A7_B002573",507,416,2876,408,2290,355,784,2092
"A7_B003067",242,247,1469,278,1658,242,398,1071
"A7_B003115",453,404,1774,369,1568,340,445,1329
"A7_B003125",1282,1073,4574,971,3782,814,1296,3278
"A7_B003126",1687,1441,8566,1387,6248,1122,2188,6378
"A7_B003132",1320,820,5611,884,2996,627,1308,4303
"A7_B003187",626,531,2632,528,1444,412,711,1921
"A7_B003191",1982,2427,10919,2066,9184,1721,3071,7848
"A7_B003518",2266,2250,11623,2102,10069,1642,3042,8581
"A7_B003523",544,454,2662,565,1725,373,617,2045
"A7_B003528",1780,1352,8995,1414,6092,1143,2108,6887
"A7_B003577",1487,1193,5716,1108,4297,837,1440,4276
"A8_1001000340",600,530,2326,609,2882,516,532,1794
"A8_B000573",383,334,1609,300,1322,273,451,1158
"A8_B000579",108,117,561,87,423,78,156,405
"A8_B000860",587,464,2611,500,2893,395,687,1924
"A8_B000863",1648,1348,8442,1218,5789,985,2086,6356
"A8_B001007",574,572,2192,533,2018,494,659,1533
"A8_B001470",1167,1016,5944,1092,4731,868,1415,4529
"A8_B001474",1144,1084,5647,1158,5180,940,1557,4090
"A8_B001475",33,24,162,27,134,21,48,114
"A8_B001543",1713,1401,8239,1413,7179,1102,2099,6140
"A8_B001545",613,595,3556,691,2563,507,871,2685
"A8_B001548",868,904,4266,783,4807,674,1071,3195
"A8_B001554",933,891,4876,906,4482,687,1306,3570
"A8_B001557",1075,1036,5640,1113,4697,822,1357,4283
"A8_B001558",1119,1011,6346,1090,4815,843,1594,4752
"A8_B002571",591,566,3615,592,2616,442,866,2749
"A8_B002572",628,511,3404,536,2123,411,838,2566
"A8_B002573",82,54,439,67,158,35,118,321
"A8_B003115",456,490,2082,459,1913,383,512,1570
"A8_B003125",653,542,2132,459,1870,414,605,1527
"A8_B003126",2334,2059,12618,1969,10632,1514,3226,9392
"A8_B003132",2735,2357,13173,2405,10503,1924,3452,9721
"A8_B003187",1402,1177,5697,1087,4191,888,1606,4091
"A8_B003191",706,730,3342,741,3370,560,869,2473
"A8_B003523",1908,1656,9764,1611,5925,1212,2510,7254
"A8_B003527",2337,1952,11598,1836,9636,1355,3086,8512
"A8_B003528",2036,1973,9985,1736,7437,1539,2726,7259
"A8_B003648",48,36,340,40,136,29,85,255
"A8_B003659",566,458,2858,452,2039,366,740,2118
"A9_10001000325",590,616,2389,397,1850,401,758,1631
"A9_1001000407",1094,1238,6184,915,4266,786,1708,4476
"A9_1001000408",1089,1227,5664,986,5362,891,1655,4009
"A9_1001000412",1455,1599,7879,1279,7512,1117,2288,5591
"A9_B000860",2207,1643,11867,1685,8737,1428,3053,8814
"A9_B000861",635,468,2949,519,2674,377,755,2194
"A9_B000862",2282,1929,12230,1847,9452,1433,3165,9065
"A9_B000863",96,70,563,70,215,41,142,421
"A9_B001007",528,468,1813,437,1733,448,594,1219
"A9_B001470",1061,924,5196,1000,4214,706,1261,3935
"A9_B001474",707,687,3512,736,3334,530,952,2560
"A9_B001475",1350,1152,5697,1247,4858,961,1434,4263
"A9_B001543",1214,1018,7303,1048,4600,747,1793,5510
"A9_B001545",360,368,2125,424,1674,331,552,1573
"A9_B001554",1406,1206,7517,1180,6721,930,1967,5550
"A9_B002572",2641,2602,17154,2590,11452,1965,4416,12738
"A9_B002573",1586,1318,8687,1411,5827,1081,2159,6528
"A9_B003115",195,198,903,192,730,149,205,698
"A9_B003119",2254,1769,9991,1879,8469,1344,2535,7456
"A9_B003518",1842,1783,8947,1627,8852,1348,2359,6588
"A9_B003527",1354,1129,7720,1133,4538,819,1894,5826
"A9_B003528",922,760,4398,761,3052,567,1058,3340
"A9_B003577",1546,1300,6307,1225,4945,923,1652,4655
"A9_B003588",1519,1521,7440,1365,10003,1186,2221,5219
"A9_B003647",3176,2797,16966,2976,14898,2177,4116,12850
"B1_1001000407",778,871,4182,624,2994,590,1195,2987
"B1_1001000408",1037,1121,5164,864,4913,746,1477,3687
"B1_B000863",212,157,1247,133,597,127,303,944
"B1_B001007",511,437,1717,397,1749,343,598,1119
"B1_B001464",1220,1098,7127,1324,5594,971,1664,5463
"B1_B001474",1895,1707,8182,1970,6866,1488,2205,5977
"B1_B001551",107,111,407,94,412,84,135,272
"B1_B001558",597,570,3459,585,2600,459,856,2603
"B1_B002571",309,274,1649,293,924,212,385,1264
"B1_B002572",347,252,1687,355,871,201,405,1282
"B1_B003080",1816,1219,8479,1273,5597,1041,2180,6299
"B1_B003115",435,449,2090,429,1729,401,515,1575
"B1_B003126",163,153,654,141,442,81,183,471
"B1_B003129",271,255,1199,276,797,222,311,888
"B1_B003132",583,467,2647,440,2215,364,674,1973
"B1_B003187",2275,2562,11642,2156,10098,2006,3437,8205
"B1_B003191",1262,1361,6883,1282,5846,1108,1835,5048
"B1_B003528",52,69,231,42,203,33,57,174
"B1_B003648",537,398,2356,491,2250,368,516,1840
"B1_B003657",3118,3188,15367,2936,12019,2410,4485,10882
"B10_1001000301",202,183,853,148,762,142,214,639
"B10_1001000302",294,242,1347,301,1289,219,286,1061
"B10_1001000340",814,759,3236,829,3551,599,764,2472
"B10_1001000407",1187,1316,6397,1019,6010,914,1740,4657
"B10_1001000408",1190,1283,6006,1085,5999,901,1741,4265
"B10_1001000411",1212,1241,5946,1016,6095,938,1721,4225
"B10_1001000412",1631,1755,8911,1407,8660,1303,2605,6306
"B10_B000860",914,686,5037,818,3527,590,1168,3869
"B10_B000861",57,61,318,44,172,31,77,241
"B10_B000862",165,136,837,107,417,106,203,634
"B10_B000863",2018,1607,11192,1498,7860,1247,2844,8348
"B10_B000887",84,96,438,70,469,87,110,328
"B10_B001007",800,600,2567,641,2529,599,885,1682
"B10_B001470",2025,1776,9715,1944,7880,1476,2512,7203
"B10_B001475",1147,1056,5328,1083,5282,880,1434,3894
"B10_B001543",851,663,4808,843,3291,534,1175,3633
"B10_B001548",2494,2306,12802,2204,10447,1725,3211,9591
"B10_B001554",2000,1680,10811,1857,8125,1399,2759,8052
"B10_B001556",306,291,1483,269,1337,210,367,1116
"B10_B001558",448,409,2266,485,2198,375,582,1684
"B10_B002572",379,343,2099,299,1165,220,549,1550
"B10_B002573",1795,1757,9426,1745,8300,1387,2452,6974
"B10_B003071",446,394,2167,432,2716,378,559,1608
"B10_B003115",343,358,1628,301,1600,280,430,1198
"B10_B003518",1500,1490,7737,1436,6299,1136,2075,5662
"B10_B003522",2268,2360,11950,2086,9667,1610,3239,8711
"B10_B003523",631,607,2880,557,3114,499,780,2100
"B10_B003528",3,3,3,2,2,0,2,1
"B10_B003529",1227,1190,5803,1163,4654,870,1498,4305
"B10_B003577",2059,1789,8271,1680,6765,1281,2180,6091
"B10_B003588",1301,1070,5564,1050,6571,834,1434,4130
"B10_B003995",571,489,2473,539,2212,378,623,1850
"B11_10001000325",845,899,3752,660,3343,641,1152,2600
"B11_1001000295",939,762,2911,954,3073,678,760,2151
"B11_1001000407",1601,1751,8539,1403,8067,1267,2445,6094
"B11_1001000408",1127,1180,5798,905,5466,863,1672,4126
"B11_1001000412",1640,1697,8711,1398,8269,1262,2483,6228
"B11_B000420",1404,1165,6744,1247,6278,870,1689,5055
"B11_B000860",689,449,3450,499,1993,352,850,2600
"B11_B000861",1351,1098,7086,1049,6316,859,1803,5283
"B11_B000862",8434,9445,38366,7630,43698,7718,11963,26403
"B11_B001007",635,533,2107,544,2014,545,622,1485
"B11_B001470",1265,1159,6368,1210,5506,896,1591,4777
"B11_B001543",514,414,2938,502,2040,343,723,2215
"B11_B001554",1613,1384,8879,1560,7477,1138,2201,6678
"B11_B001557",675,571,3412,626,2572,437,824,2588
"B11_B001558",343,319,1819,322,1436,253,493,1326
"B11_B002572",2774,2663,14053,2663,11555,2101,3792,10261
"B11_B003067",1768,1549,8853,1744,10924,1360,2229,6624
"B11_B003115",777,603,3007,687,2693,569,786,2221
"B11_B003518",1792,1791,9469,1698,7848,1412,2580,6889
"B11_B003527",1794,1785,9743,1568,8633,1292,2555,7188
"B11_B003528",1716,1510,8912,1428,6075,1190,2318,6594
"B11_B003588",767,549,3445,606,5681,430,919,2526
"B12_1001000407",1921,2066,10102,1643,9465,1458,2824,7278
"B12_1001000408",1364,1425,6949,1185,6426,1052,2026,4923
"B12_1001000412",1492,1541,7680,1314,8295,1139,2200,5480
"B12_B001007",409,355,1366,341,1353,320,440,926
"B12_B001008",857,739,4728,673,2384,476,1201,3527
"B12_B001010",1267,1133,7488,1262,5447,931,1846,5642
"B12_B001557",211,161,750,176,1002,166,239,511
"B12_B002077",3589,4271,18955,3334,18212,3162,5786,13169
"B12_B002573",370,263,1984,270,1036,179,502,1482
"B12_B003067",1777,1617,9982,1692,8588,1309,2582,7400
"B12_B003105",646,554,3899,624,2324,428,935,2964
"B12_B003116",2127,2149,9117,1800,7656,1546,2561,6556
"B12_B003120",69,44,316,43,141,26,76,240
"B12_B003518",1478,1537,6979,1424,8252,1191,1928,5051
"B12_B003527",2161,1940,10684,1857,9283,1452,2895,7789
"B12_B003528",969,859,5180,973,3752,752,1248,3932
"B12_B003529",685,650,3316,689,2382,504,853,2463
"B12_B003588",1362,1276,6903,1283,7033,1074,1851,5052
"B12_B003771",2025,1741,10771,1816,8849,1330,2781,7990
"B12_B003776",4561,4418,23714,4317,21178,3389,6378,17336
"B12_B003920",484,452,2165,455,2421,389,567,1598
"B12_B003930",3154,3367,15832,2921,14153,2431,4277,11555
"B13_1001000340",1318,1131,4600,1313,6523,1046,1186,3414
"B13_1001000407",1563,1733,8840,1374,8223,1267,2474,6366
"B13_1001000408",1040,1189,5553,986,5375,922,1671,3882
"B13_1001000412",1504,1651,8623,1317,7973,1179,2412,6211
"B13_B000420",478,388,2559,419,2165,288,612,1947
"B13_B000422",4086,4313,20131,3945,17978,3347,5528,14603
"B13_B000579",151,193,815,124,639,125,218,597
"B13_B001007",1213,930,3661,1030,3543,917,1140,2521
"B13_B001008",938,768,4737,826,3981,631,1109,3628
"B13_B001010",2127,1905,12304,2028,9438,1457,3016,9288
"B13_B001016",627,499,3535,565,2186,422,865,2670
"B13_B001543",804,627,4592,755,3187,531,1078,3514
"B13_B001557",1511,1235,7711,1432,6481,1046,1928,5783
"B13_B002077",2080,2149,10527,1879,9607,1582,3081,7446
"B13_B002079",1508,1527,5921,1231,6782,935,1647,4274
"B13_B003105",856,705,5175,767,2870,564,1268,3907
"B13_B003112",2669,2816,13795,2596,11471,2133,3861,9934
"B13_B003116",4710,5285,22030,4423,20595,4030,6542,15488
"B13_B003518",2626,2991,13230,2690,16741,2402,3828,9402
"B13_B003522",861,799,5324,896,3278,649,1333,3991
"B13_B003527",1398,1286,7697,1263,6719,962,2029,5668
"B13_B003528",0,0,0,0,1,0,0,0
"B13_B003529",3184,3179,14813,2930,12526,2449,4088,10725
"B13_B003588",159,115,852,109,567,69,233,619
"B13_B003771",1834,1620,9085,1730,9218,1232,2315,6770
"B13_B003775",894,648,4696,818,3361,559,1114,3582
"B13_B003776",2348,2230,11361,2170,11138,1899,3193,8168
"B13_B003777",1207,1067,4737,1220,4056,857,1176,3561
"B13_B003894",225,140,713,166,363,95,169,544
"B13_B003920",1446,1413,7120,1405,6080,1074,1852,5268
"B14_1001000407",1601,1708,8743,1417,7973,1120,2539,6204
"B14_1001000408",1267,1314,6662,1127,6034,999,1939,4723
"B14_1001000412",1458,1615,7908,1263,7827,1089,2313,5595
"B14_B000422",616,573,3003,657,3093,480,703,2300
"B14_B001008",611,436,3392,474,1585,289,862,2530
"B14_B001557",757,719,4035,863,4896,580,1018,3017
"B14_B002073",930,845,4981,889,8554,681,1288,3693
"B14_B002074",368,368,1799,373,3162,286,457,1342
"B14_B002077",933,831,4506,836,6082,682,1201,3305
"B14_B002078",2516,2326,12565,2463,12970,2038,3328,9237
"B14_B003112",2580,2727,13628,2553,11654,2077,3681,9947
"B14_B003116",2102,2124,9472,1856,9697,1611,2717,6755
"B14_B003125",379,291,2086,323,1630,184,515,1571
"B14_B003126",483,378,2483,404,1751,298,617,1866
"B14_B003191",255,286,1611,241,1334,214,414,1197
"B14_B003518",1409,1426,6433,1326,6316,991,1793,4640
"B14_B003527",2616,2353,12052,2277,16376,1877,3483,8569
"B14_B003528",1111,837,5592,982,4137,656,1402,4190
"B14_B003588",3064,2989,15908,2656,15893,2231,4431,11477
"B14_B003771",313,238,2007,268,900,166,498,1509
"B14_B003776",971,960,5406,967,6003,817,1339,4067
"B14_B003777",678,647,3390,606,2783,457,895,2495
"B14_B003930",876,858,4372,855,3463,593,1149,3223
"B14_B003995",193,121,772,128,343,72,212,560
"B15_1001000339",1190,1189,4905,1118,4681,936,1220,3685
"B15_1001000340",891,852,3661,824,3616,607,955,2706
"B15_1001000407",1809,2031,9909,1677,10193,1482,2824,7085
"B15_1001000408",1084,1267,5944,951,5452,833,1730,4214
"B15_1001000412",1445,1645,7925,1279,7475,1139,2231,5694
"B15_B000422",2236,2150,10099,2137,8572,1592,2657,7442
"B15_B000579",2901,2720,14697,2534,13750,2059,4142,10555
"B15_B001007",544,475,1753,488,1731,449,572,1181
"B15_B001010",1940,1645,10870,1759,7338,1262,2769,8101
"B15_B001543",412,356,2339,443,1730,303,621,1718
"B15_B002073",1363,1299,7936,1238,6052,979,1945,5991
"B15_B002074",1187,1316,5828,1017,4852,917,1683,4145
"B15_B002077",2144,2124,10311,1979,8757,1690,2805,7506
"B15_B002079",2219,2097,11252,2015,10753,1600,3043,8209
"B15_B002097",616,439,2631,414,2148,357,638,1993
"B15_B002572",2818,2676,18341,2883,13012,2080,4533,13808
"B15_B003070",1341,1240,8007,1292,7818,1028,1982,6025
"B15_B003103",180,153,886,149,473,104,208,678
"B15_B003105",1003,921,5866,911,3348,675,1358,4508
"B15_B003112",294,207,1324,273,730,167,292,1032
"B15_B003120",253,166,1073,178,1007,141,261,812
"B15_B003125",256,186,1334,213,994,141,310,1024
"B15_B003126",430,387,2246,356,1665,307,593,1653
"B15_B003187",1890,2061,8342,1576,8751,1461,2488,5854
"B15_B003191",1181,1193,7413,1102,3586,804,1841,5572
"B15_B003518",2108,2169,11124,2086,8917,1660,3076,8048
"B15_B003527",1351,1241,7547,1238,7229,926,1979,5568
"B15_B003528",770,584,3808,656,2723,539,901,2907
"B15_B003529",2134,2079,9976,1994,9865,1596,2684,7292
"B15_B003771",1113,890,5998,1077,4758,694,1465,4533
"B15_B003775",167,156,741,147,861,151,216,525
"B15_B003776",3235,3458,16877,3142,16289,2659,4676,12201
"B15_B003777",707,737,3127,623,3074,579,928,2199
"B15_B003894",2456,2534,10846,2370,11681,1901,3052,7794
"B15_B003920",4618,4725,21205,4141,19574,3463,6157,15048
"B15_B003930",2145,2146,10276,2018,8996,1654,2790,7486
"B16_1001000339",791,637,2463,762,3154,685,582,1881
"B16_1001000340",1166,994,3956,1195,5211,1059,1010,2946
"B16_1001000407",1687,1773,9043,1391,8582,1247,2605,6438
"B16_1001000408",867,985,4541,758,4856,683,1329,3212
"B16_B000420",986,915,4270,914,4355,760,1136,3134
"B16_B000422",1388,1406,6739,1354,7106,1100,1848,4891
"B16_B001010",1886,1661,10574,1790,7711,1405,2673,7901
"B16_B001016",825,681,4632,757,3131,570,1121,3511
"B16_B001557",1397,1281,7619,1351,5769,1005,1907,5712
"B16_B002074",418,430,1886,390,1981,289,537,1349
"B16_B002077",2038,2063,10040,1782,9966,1643,2843,7197
"B16_B002078",920,697,4423,715,3121,508,1123,3300
"B16_B002079",1607,1431,8330,1632,6284,1171,2225,6105
"B16_B002097",491,446,2607,381,2114,312,666,1941
"B16_B002572",2540,2467,16451,2334,9560,1762,4264,12187
"B16_B003067",764,694,4167,676,3926,525,1024,3143
"B16_B003070",993,934,5373,960,5993,741,1386,3987
"B16_B003078",1134,847,3896,747,3950,807,1135,2761
"B16_B003103",3699,3867,17990,3412,15478,2806,5237,12753
"B16_B003112",3276,3598,16635,3153,15078,2551,4709,11926
"B16_B003116",4853,4986,20768,4243,20074,3699,5978,14790
"B16_B003120",1293,835,6175,1001,3967,708,1444,4731
"B16_B003125",381,295,1832,291,1233,183,426,1406
"B16_B003126",616,585,2943,585,4036,418,721,2222
"B16_B003132",164,110,774,107,375,94,185,589
"B16_B003187",2188,2269,10238,1795,8446,1545,3154,7084
"B16_B003191",107,79,480,105,310,86,98,382
"B16_B003518",946,750,4354,799,3895,567,1164,3190
"B16_B003522",2748,2991,15197,2754,13886,2259,4034,11163
"B16_B003527",2202,2195,11444,1928,11498,1623,3172,8272
"B16_B003528",723,664,3857,709,2872,507,954,2903
"B16_B003588",327,255,1254,209,1657,222,332,922
"B16_B003771",1050,737,5223,806,3585,560,1218,4005
"B16_B003775",174,141,826,136,431,105,197,629
"B16_B003776",1962,1891,9828,1911,10004,1532,2555,7273
"B16_B003777",3077,3339,13691,3089,11843,2617,3995,9696
"B16_B003920",2394,2394,11591,2366,9848,1801,3226,8365
"B16_B003995",2658,2318,13565,2335,10131,1782,3503,10062
"B17_1001000339",1365,1192,5041,1285,6167,1068,1338,3703
"B17_1001000340",771,732,2958,692,3147,609,745,2213
"B17_1001000407",1870,2036,10362,1614,9467,1388,2962,7400
"B17_1001000408",1229,1336,6579,1055,5951,951,1883,4696
"B17_1001000412",1593,1673,8520,1374,7917,1244,2451,6069
"B17_B000420",1177,1155,4963,1040,6165,903,1373,3590
"B17_B000422",1147,1100,5434,1086,4136,793,1417,4017
"B17_B001007",517,458,1679,408,1629,389,527,1152
"B17_B001008",670,482,3278,576,2170,397,748,2530
"B17_B001557",652,538,3414,701,2772,466,870,2544
"B17_B002073",1114,1016,7459,1100,4721,797,1921,5538
"B17_B002077",938,837,4505,887,3367,628,1143,3362
"B17_B002078",974,817,5404,890,4054,653,1325,4079
"B17_B002079",3635,3736,18709,3251,15422,2804,5120,13589
"B17_B002097",750,682,4163,659,2926,476,1075,3088
"B17_B003067",1571,1458,9328,1544,8491,1227,2326,7002
"B17_B003070",56,50,299,40,205,31,80,219
"B17_B003071",586,634,3323,617,4014,523,843,2480
"B17_B003103",3292,3316,15634,2921,14615,2503,4449,11185
"B17_B003105",1227,1009,6913,1036,4309,787,1590,5323
"B17_B003120",914,645,4714,735,3334,523,1164,3550
"B17_B003527",997,834,5075,849,4562,604,1300,3775
"B17_B003528",558,489,2650,495,2036,389,614,2036
"B17_B003529",3372,3730,16056,3046,14625,2762,4546,11510
"B17_B003588",1167,761,5438,808,2915,532,1322,4116
"B17_B003654",665,502,3695,586,2641,418,932,2763
"B17_B003776",627,531,3344,573,2576,396,796,2548
"B17_B003894",1549,1593,7088,1398,7024,1128,1974,5114
"B17_B003930",1076,1031,5006,931,3876,740,1365,3641
"B17_B003995",167,103,934,132,372,78,231,703
"B18_1001000339",995,954,3925,949,3670,757,1008,2917
"B18_1001000407",2267,2399,12480,2045,12669,1785,3504,8976
"B18_1001000408",1311,1357,6650,1136,6244,1027,1857,4793
"B18_1001000412",1604,1885,8609,1442,8612,1280,2550,6059
"B18_B000420",480,498,1892,441,2565,402,564,1328
"B18_B000422",1738,1670,8094,1677,7059,1334,2158,5936
"B18_B001008",411,349,1916,413,1961,287,440,1476
"B18_B001557",654,548,3048,586,2426,415,788,2260
"B18_B002073",122,106,746,95,388,82,185,561
"B18_B002074",428,353,2168,403,2062,356,540,1628
"B18_B002078",95,74,547,65,219,46,141,406
"B18_B002079",951,811,4514,820,3389,635,1128,3386
"B18_B002572",2917,2967,18322,2740,13166,2116,4828,13494
"B18_B003103",2408,2435,11637,2227,9375,1751,3221,8416
"B18_B003112",1214,1143,5620,1139,5432,804,1470,4150
"B18_B003120",960,671,4591,740,3156,529,1168,3423
"B18_B003518",850,840,4425,843,3779,597,1150,3275
"B18_B003527",1860,1437,8110,1365,6703,1010,2144,5966
"B18_B003528",963,703,5306,827,3510,586,1201,4105
"B18_B003588",2431,2092,11600,2073,10790,1625,3167,8433
"B18_B003654",675,522,3434,565,2509,427,892,2542
"B18_B003771",239,177,1429,172,580,117,336,1093
"B18_B003775",82,61,402,71,252,48,91,311
"B18_B003776",1962,1827,9219,1804,9554,1425,2472,6747
"B18_B003777",2359,2435,11880,2292,11966,1857,3477,8403
"B18_B003894",2142,2206,9633,2012,9417,1667,2750,6883
"B18_B003920",5119,5704,25434,4710,23357,4155,7596,17838
"B18_B003995",251,171,1557,204,700,129,354,1203
"B19_1001000339",1110,1069,4437,1040,4571,851,1140,3297
"B19_1001000407",1938,2167,10658,1775,9955,1532,3077,7581
"B19_1001000408",1298,1414,6560,1057,6286,1022,1878,4682
"B19_B000420",1400,1353,5599,1207,5970,993,1519,4080
"B19_B000422",2128,2128,10164,2017,8817,1584,2788,7376
"B19_B001010",1283,1223,7104,1271,6292,953,1747,5357
"B19_B002073",1057,947,6315,928,4193,705,1627,4688
"B19_B002074",994,805,4889,768,3985,668,1291,3598
"B19_B002077",709,530,3108,552,2308,406,740,2368
"B19_B002079",1494,1419,7364,1468,9001,1111,1973,5391
"B19_B002572",2178,2214,12043,1919,8587,1547,3261,8782
"B19_B003071",960,975,4149,947,6002,805,1081,3068
"B19_B003103",3893,3940,19355,3553,17431,2912,5288,14067
"B19_B003116",3625,3725,15685,3220,14594,2744,4497,11188
"B19_B003518",914,742,4400,863,3417,620,1072,3328
"B19_B003528",3,2,20,2,14,1,8,12
"B19_B003646",212,159,1037,159,751,148,234,803
"B19_B003654",422,325,2035,351,1476,283,509,1526
"B19_B003771",2345,2106,12271,2114,9659,1583,3137,9134
"B19_B003776",1810,1704,8967,1593,8020,1268,2281,6686
"B19_B003777",957,914,4548,832,3414,654,1250,3298
"B19_B003894",4112,4493,19352,3824,18577,3175,5683,13669
"B19_B003920",412,387,1738,389,1713,288,443,1295
"B19_B003930",371,354,1683,327,757,229,394,1289
"B2_1001000301",373,334,1490,255,1536,261,426,1064
"B2_1001000317",544,650,2691,392,2239,469,837,1854
"B2_1001000412",1230,1311,6799,944,4899,879,1959,4840
"B2_B000861",1140,1032,5051,923,5479,920,1705,3346
"B2_B000863",1628,1232,8927,1226,5965,957,2189,6738
"B2_B000901",94,74,591,51,289,54,160,431
"B2_B001007",1082,1081,4128,964,3961,956,1303,2825
"B2_B001464",2217,2024,13598,2177,9665,1563,3333,10265
"B2_B001470",1195,1140,5913,1107,4547,856,1509,4404
"B2_B001474",1923,1939,9069,2057,7442,1676,2446,6623
"B2_B001543",1257,958,6871,1067,4729,744,1651,5220
"B2_B001551",224,203,900,172,910,180,301,599
"B2_B001558",2020,1960,10991,1898,8605,1514,2982,8009
"B2_B002573",103,65,561,80,214,57,133,428
"B2_B003067",1224,1163,6892,1086,4983,858,1816,5076
"B2_B003070",1120,889,6207,892,4874,638,1535,4672
"B2_B003071",1012,1062,5889,1002,5199,824,1543,4346
"B2_B003126",1665,1387,8955,1439,6760,1020,2270,6685
"B2_B003129",843,819,3644,799,3074,603,955,2689
"B2_B003132",1162,954,5267,1029,3465,777,1280,3987
"B2_B003191",2984,3406,14008,2665,12876,2451,4038,9970
"B2_B003528",34,36,148,42,122,35,41,107
"B2_B003648",67,63,360,60,218,45,103,257
"B2_B003659",1908,1606,9436,1559,7945,1205,2380,7056
"B2_B003995",646,642,1732,291,991,190,454,1278
"B20_1001000339",752,640,2581,773,3150,638,619,1962
"B20_1001000407",1822,2051,9935,1662,9817,1418,2790,7145
"B20_1001000408",1142,1210,6034,1010,5808,896,1750,4284
"B20_1001000412",1035,1095,5309,721,4308,701,1551,3758
"B20_B000420",705,616,2685,587,3192,550,815,1870
"B20_B000422",1230,1168,5899,1202,5148,914,1495,4404
"B20_B000901",890,662,2715,612,2677,630,925,1790
"B20_B001007",363,341,1165,272,1268,290,400,765
"B20_B001008",716,530,3477,576,2433,395,778,2699
"B20_B001010",861,610,4031,792,3836,533,1037,2994
"B20_B001557",710,612,3396,788,2806,543,888,2508
"B20_B002073",355,342,2243,296,1846,240,580,1663
"B20_B002074",166,151,708,113,482,120,226,482
"B20_B002078",547,457,2461,477,2561,393,644,1817
"B20_B002079",2676,2561,14069,2480,10987,1918,3760,10309
"B20_B002097",183,178,1145,157,608,101,306,839
"B20_B002572",1960,2001,13077,1754,8254,1345,3432,9645
"B20_B003103",3283,3100,15728,2936,12658,2244,4235,11493
"B20_B003112",674,661,3182,674,3378,531,857,2325
"B20_B003518",1539,1470,7674,1445,7593,1150,1982,5692
"B20_B003522",1442,1417,7518,1227,5344,974,1964,5554
"B20_B003527",1300,1003,6342,1022,4974,738,1623,4719
"B20_B003528",318,239,1833,253,1107,162,441,1392
"B20_B003529",652,517,2985,587,2096,440,742,2243
"B20_B003646",302,225,1535,250,1492,172,398,1137
"B20_B003894",447,402,1847,394,2307,277,486,1361
"B20_B003930",2575,2529,12945,2322,9987,1824,3546,9399
"B21_1001000407",1618,1902,8918,1466,9033,1324,2511,6407
"B21_1001000408",1002,1078,5050,777,4081,713,1453,3597
"B21_1001000412",1240,1356,6564,974,6284,939,1859,4705
"B21_B000420",404,396,1558,347,1830,297,409,1149
"B21_B000422",1511,1392,7429,1399,6756,1054,1889,5540
"B21_B000901",1224,980,3894,911,3795,904,1344,2550
"B21_B001557",895,697,4080,836,3557,622,1041,3039
"B21_B002073",512,429,2612,436,2469,304,699,1913
"B21_B002074",604,581,2496,450,2383,434,731,1765
"B21_B002077",2024,1867,8964,1719,8703,1375,2613,6351
"B21_B002079",2115,1888,10946,1952,10307,1549,2856,8090
"B21_B002572",2802,2974,17055,2663,12027,2055,4457,12598
"B21_B003103",1484,1374,6942,1386,6484,1024,1871,5071
"B21_B003116",2700,2615,10710,2247,10262,1912,3093,7617
"B21_B003125",168,151,829,172,722,115,214,615
"B21_B003518",1609,1518,7606,1448,6794,1097,2140,5466
"B21_B003522",1952,1602,15057,1850,8583,1159,3700,11357
"B21_B003528",104,70,410,92,363,67,90,320
"B21_B003588",371,308,1528,313,2028,225,368,1160
"B21_B003646",442,293,2073,334,1491,254,473,1600
"B21_B003654",1236,963,5891,913,4516,717,1494,4397
"B21_B003771",2666,2457,13656,2360,10852,1879,3562,10094
"B21_B003776",1032,940,4953,919,6474,770,1308,3645
"B21_B003777",3133,3411,15682,3131,16387,2601,4337,11345
"B21_B003894",1205,1222,5666,1118,5668,853,1612,4054
"B21_B003920",2037,2029,9399,1903,8999,1465,2675,6724
"B21_B003995",1846,1438,10125,1632,6863,1167,2450,7675
"B22_1001000339",645,685,2902,625,2828,494,765,2137
"B22_1001000340",1151,1008,4273,1057,4752,824,1120,3153
"B22_1001000407",1890,1880,9582,1575,8998,1322,2700,6882
"B22_1001000408",1444,1570,7561,1329,7592,1217,2178,5383
"B22_1001000412",1588,1718,8711,1354,7857,1176,2407,6304
"B22_B000420",921,897,3457,760,3262,615,972,2485
"B22_B000422",794,781,3954,822,4573,653,1053,2901
"B22_B000883",547,447,1776,423,1649,431,606,1170
"B22_B001010",1784,1465,10226,1700,7039,1107,2633,7593
"B22_B002074",1290,1271,6037,1113,5178,1061,1824,4213
"B22_B002077",467,354,1948,348,1507,256,471,1477
"B22_B002079",654,590,2987,536,2872,471,756,2231
"B22_B002572",2388,2094,11547,1804,7854,1340,3042,8505
"B22_B003103",538,453,2389,408,1740,322,631,1758
"B22_B003112",870,745,4034,763,4123,635,1062,2972
"B22_B003120",976,715,4697,735,3641,587,1104,3593
"B22_B003126",419,324,1923,318,2169,272,528,1395
"B22_B003129",101,63,383,69,195,57,83,300
"B22_B003132",335,233,1637,291,1042,206,392,1245
"B22_B003187",178,133,688,141,544,117,186,502
"B22_B003518",1386,1374,6602,1220,5343,920,1841,4761
"B22_B003528",285,228,1652,214,994,159,373,1279
"B22_B003529",1407,1236,6395,1151,4857,923,1701,4694
"B22_B003646",412,311,1963,339,1540,243,486,1477
"B22_B003771",905,665,4684,805,4190,519,1052,3632
"B22_B003775",1014,296,1982,307,1411,230,516,1466
"B22_B003776",1019,917,5201,913,4414,671,1342,3859
"B22_B003894",621,516,2386,485,2082,336,623,1763
"B22_B003920",1112,1040,4777,982,5577,759,1388,3389
"B22_B003930",229,162,809,173,693,128,200,609
"B3_1001000315",543,559,2588,435,2208,407,699,1889
"B3_1001000407",1835,2052,9913,1704,9381,1442,2773,7140
"B3_B000860",399,278,2114,271,1115,213,547,1567
"B3_B000861",218,208,807,177,723,169,252,555
"B3_B000862",298,257,1838,198,868,190,447,1391
"B3_B000863",1848,1453,9582,1379,6793,968,2342,7240
"B3_B001007",631,504,2047,471,1934,487,623,1424
"B3_B001470",1166,1023,5538,1086,4411,787,1367,4171
"B3_B001474",573,500,2308,538,1436,389,585,1723
"B3_B001543",1713,1497,9361,1375,6900,1072,2339,7022
"B3_B001558",759,723,4709,774,3316,610,1177,3532
"B3_B001559",618,482,3523,645,2834,458,844,2679
"B3_B003071",785,742,4641,715,4278,535,1151,3490
"B3_B003121",357,312,1770,296,1244,231,463,1307
"B3_B003126",373,311,1858,334,1369,239,464,1394
"B3_B003129",1110,1046,4708,1029,4554,799,1280,3428
"B3_B003132",311,244,1351,260,946,193,315,1036
"B3_B003187",891,861,4039,783,3603,648,1104,2935
"B3_B003191",1191,1416,6177,1224,4897,1037,1696,4481
"B3_B003528",36,27,111,23,96,18,29,82
"B3_B003648",716,549,4092,617,2591,460,966,3126
"B3_B003659",507,416,2648,419,1624,351,651,1997
"B4_1001000302",283,221,1382,262,1173,235,300,1082
"B4_1001000317",84,122,458,69,329,99,142,316
"B4_1001000340",1359,1406,5514,1250,5401,1005,1423,4091
"B4_B000861",196,224,921,140,750,149,278,643
"B4_B000862",257,235,1338,203,688,172,340,998
"B4_B001007",564,519,2083,471,2032,452,759,1324
"B4_B001464",2511,2120,14882,2444,11543,1839,3488,11394
"B4_B001474",1015,924,4833,1012,4137,767,1280,3553
"B4_B001543",2108,1716,11073,1893,8592,1493,2678,8395
"B4_B001557",1083,1042,5501,1151,5079,930,1299,4202
"B4_B001558",644,549,3441,634,2816,482,833,2608
"B4_B002572",492,333,2575,396,1224,281,618,1957
"B4_B002573",280,229,1401,190,658,125,353,1048
"B4_B003067",1223,1236,6693,1221,6388,987,1818,4875
"B4_B003115",461,375,1831,315,1677,342,490,1341
"B4_B003129",314,225,1278,246,634,169,323,955
"B4_B003132",784,669,3986,668,2684,512,934,3052
"B4_B003187",938,919,4275,920,2965,694,1189,3086
"B4_B003191",3068,3560,14847,2789,13482,2434,4408,10439
"B4_B003518",520,555,2540,476,2199,453,700,1840
"B4_B003528",45,58,184,49,195,37,43,141
"B4_B003648",837,716,3982,729,4177,626,895,3087
"B4_B003995",1838,1756,12539,1866,8525,1353,3120,9419
"B5_10001000325",646,691,2952,518,2545,545,868,2084
"B5_1001000301",331,326,1657,263,1506,271,450,1207
"B5_1001000302",329,273,1595,297,1506,271,386,1209
"B5_1001000327",209,256,895,121,635,152,262,633
"B5_1001000340",838,855,3468,819,3234,619,868,2600
"B5_1001000407",1683,1715,8659,1519,8393,1260,2451,6208
"B5_1001000412",1267,1275,6809,1048,5721,873,1921,4888
"B5_B000860",303,195,1704,207,809,157,413,1291
"B5_B000861",463,395,1774,300,1329,323,504,1270
"B5_B000863",1762,1367,9450,1263,6084,973,2427,7023
"B5_B001007",547,494,2032,488,1928,443,645,1387
"B5_B001464",2026,1752,12405,1959,9114,1453,2986,9419
"B5_B001470",1080,953,5798,1102,4084,771,1394,4404
"B5_B001474",952,762,4270,873,2897,587,1085,3185
"B5_B001545",652,550,3653,646,2967,461,895,2758
"B5_B001548",1359,1291,6007,1224,6370,944,1633,4374
"B5_B001551",854,843,4424,801,4324,663,1214,3210
"B5_B001558",456,461,3106,433,1735,374,780,2326
"B5_B001559",651,616,3306,562,2944,454,845,2461
"B5_B002572",3184,3365,18805,2878,12895,2247,4983,13822
"B5_B003113",440,323,1221,260,1106,265,398,823
"B5_B003126",1140,939,5932,989,5039,742,1492,4440
"B5_B003129",1933,1872,8335,1687,6817,1542,2379,5956
"B5_B003187",871,685,3230,697,2168,571,832,2398
"B5_B003191",1999,2162,9584,1869,8040,1605,2685,6899
"B5_B003528",86,78,485,84,314,64,135,350
"B5_B003577",1852,1522,8209,1543,6219,1179,2102,6107
"B5_B003995",160,143,811,126,456,101,215,596
"B6_1001000317",540,579,2493,404,2110,396,710,1783
"B6_1001000340",906,794,3337,855,4396,684,864,2473
"B6_1001000408",84,140,614,81,368,84,165,449
"B6_1001000412",1679,1710,8553,1485,8411,1155,2427,6126
"B6_B000862",197,204,1290,190,569,132,324,966
"B6_B000863",628,456,3179,436,1974,292,779,2400
"B6_B001007",683,641,2648,626,2575,603,839,1809
"B6_B001470",911,786,4763,838,3382,633,1167,3596
"B6_B001474",990,878,4698,953,4310,767,1338,3360
"B6_B001545",1664,1429,9357,1567,6107,1151,2096,7261
"B6_B001548",131,148,646,162,674,146,165,481
"B6_B001554",1001,1010,5112,759,5474,629,1507,3605
"B6_B001557",2056,1749,10987,1927,9452,1428,2709,8278
"B6_B001558",469,403,2313,402,2152,322,618,1695
"B6_B003070",1064,972,6294,1069,5608,824,1626,4668
"B6_B003125",1310,1099,4715,991,4605,881,1386,3329
"B6_B003126",1165,985,6359,1012,4197,775,1590,4769
"B6_B003132",210,161,1181,166,537,110,266,915
"B6_B003187",130,84,566,96,280,78,127,439
"B6_B003191",4023,4837,20266,3968,19783,3498,5867,14399
"B7_1001000301",366,340,1732,312,1682,278,472,1260
"B7_1001000339",1144,1017,4313,988,5053,800,1054,3259
"B7_1001000407",1722,1800,9504,1562,8202,1327,2608,6896
"B7_1001000408",1212,1283,6262,976,5692,888,1743,4519
"B7_1001000412",1678,1845,9200,1444,8732,1409,2518,6682
"B7_B001470",1665,1601,8351,1708,7147,1254,2132,6219
"B7_B001474",1792,1599,9052,1745,6901,1292,2429,6623
"B7_B001475",506,492,2336,516,1855,357,637,1699
"B7_B001543",460,356,2392,480,2400,308,585,1807
"B7_B001545",625,631,3547,663,2796,505,827,2720
"B7_B001548",1930,1871,9649,1871,8345,1522,2589,7060
"B7_B001554",745,658,3964,636,3371,533,1032,2932
"B7_B001558",395,375,2457,436,1818,329,631,1826
"B7_B002572",3381,3240,21523,3121,14098,2566,5405,16118
"B7_B002573",244,155,1444,178,674,106,352,1092
"B7_B003070",857,790,5408,843,4769,598,1402,4006
"B7_B003125",1146,986,4186,881,3590,767,1332,2854
"B7_B003126",595,490,3045,485,2157,372,750,2295
"B7_B003129",386,340,1826,340,1255,300,457,1369
"B7_B003132",901,614,4385,721,2616,519,1027,3358
"B7_B003187",1772,1648,7655,1463,5951,1183,2268,5387
"B7_B003518",486,434,2422,404,1091,309,620,1802
"B7_B003523",1012,821,4992,918,3382,724,1132,3860
"B7_B003527",1266,1138,6520,1150,7311,921,1774,4746
"B7_B003528",1,1,7,4,3,1,1,6
"B7_B003648",1006,766,5245,777,3637,594,1304,3941
"B7_B003658",2678,2485,14829,2351,12147,1867,4008,10821
"B7_B003659",215,192,1228,197,614,159,325,903
"B7_B003995",1553,1169,8509,1250,7007,881,2133,6376
"B8_1001000302",406,350,2036,406,1896,330,458,1578
"B8_1001000317",578,663,2811,405,2318,440,872,1939
"B8_1001000407",2177,2290,11210,1922,10679,1652,3107,8103
"B8_1001000408",1105,1180,5649,921,5422,823,1644,4005
"B8_B000862",929,678,4997,745,3409,548,1158,3839
"B8_B001007",632,563,2213,571,2173,572,711,1502
"B8_B001474",1149,958,5107,1141,4854,829,1261,3846
"B8_B001475",1270,1080,5497,1191,5749,866,1423,4074
"B8_B001545",788,673,4131,776,2871,548,1019,3112
"B8_B001548",586,502,2356,595,2430,406,557,1799
"B8_B001551",1185,1086,5821,1161,5476,842,1454,4367
"B8_B001558",556,487,2473,386,1638,317,639,1834
"B8_B002572",3260,3262,16460,3194,13920,2601,4390,12070
"B8_B003070",1099,1005,6467,1007,5643,777,1613,4854
"B8_B003125",566,560,2431,453,2002,422,687,1744
"B8_B003126",333,278,1992,337,1999,221,492,1500
"B8_B003129",1054,1168,5013,1034,4424,857,1432,3581
"B8_B003132",2203,1820,11256,1933,8942,1579,2843,8413
"B8_B003187",956,893,4265,765,2994,620,1143,3122
"B8_B003191",1884,2046,9735,1815,7803,1449,2637,7098
"B8_B003518",1694,1687,8420,1579,7111,1187,2152,6268
"B8_B003523",1553,1448,8315,1481,5719,1107,1951,6364
"B8_B003527",1568,1312,8665,1301,6458,1012,2136,6529
"B8_B003528",2399,2149,11419,2061,8759,1702,2998,8421
"B8_B003648",1753,1322,8905,1502,9379,1127,2101,6804
"B8_B003995",694,522,3999,587,2596,401,918,3081
"B9_1001000302",211,185,1046,206,939,154,239,807
"B9_1001000407",1646,1690,8635,1500,8340,1362,2309,6326
"B9_1001000408",982,1078,5318,847,4983,763,1552,3766
"B9_1001000412",1461,1513,7737,1244,7638,1094,2236,5501
"B9_B000863",292,227,1600,221,850,157,343,1257
"B9_B001007",1006,974,3544,914,3454,915,1085,2459
"B9_B001475",488,475,1891,503,1964,431,555,1336
"B9_B001545",268,247,1352,304,1501,188,277,1075
"B9_B001554",1099,943,5847,911,4571,806,1542,4305
"B9_B001558",507,433,3178,486,2123,341,808,2370
"B9_B003067",848,767,4656,827,4294,599,1196,3460
"B9_B003071",856,725,4632,841,4594,653,1156,3476
"B9_B003093",2045,2221,9949,1916,9865,1664,2706,7243
"B9_B003115",457,411,1992,488,1937,373,516,1476
"B9_B003518",1976,1882,8891,1768,8551,1383,2330,6561
"B9_B003522",2593,2735,13317,2415,11560,1981,3740,9577
"B9_B003523",869,849,4051,811,4009,640,1128,2923
"B9_B003528",707,521,3407,597,2310,441,773,2634
"B9_B003577",1596,1614,7081,1495,6680,1327,2065,5016
"B9_B003588",1497,1457,6793,1346,7937,1187,1922,4871
"C1_1001000317",759,832,3542,551,2973,519,1107,2435
"C1_1001000408",1373,1476,7113,1268,6332,1107,1992,5121
"C1_B000862",225,211,1133,159,674,169,297,836
"C1_B000863",1844,1509,10090,1386,7127,1129,2448,7642
"C1_B000883",54,44,290,36,107,30,90,200
"C1_B001007",1105,969,3884,898,3697,898,1260,2624
"C1_B001464",913,925,5937,1085,4102,704,1465,4472
"C1_B001470",731,592,3752,752,2641,483,965,2787
"C1_B001474",1895,1807,8179,1835,8205,1467,2325,5854
"C1_B001543",1176,1049,6775,1052,4598,777,1657,5118
"C1_B001556",1455,1233,7984,1388,5738,992,2020,5964
"C1_B001557",1451,1255,6770,1419,6109,1084,1712,5058
"C1_B001558",855,842,5176,917,4348,682,1341,3835
"C1_B002568",122,92,399,56,418,72,120,279
"C1_B002571",38,42,301,36,155,31,76,225
"C1_B002572",2163,2232,13830,1921,8217,1463,3514,10316
"C1_B003071",606,573,3505,627,3417,486,834,2671
"C1_B003115",916,942,4239,837,3968,695,1225,3014
"C1_B003126",1401,1183,6801,1404,7106,1123,1686,5115
"C1_B003129",1261,1136,5782,1191,4042,931,1511,4271
"C1_B003132",456,360,2345,478,1193,311,567,1778
"C1_B003187",1459,1347,6576,1327,5190,1096,1759,4817
"C1_B003191",275,218,1414,275,680,186,358,1056
"C1_B003577",1319,1324,5905,1222,5655,1034,1674,4231
"C1_B003642",2476,2096,12091,2001,8971,1556,3415,8676
"C1_B003657",2306,2118,10613,2148,8906,1814,3003,7610
"C1_B003995",2007,1441,8114,1507,6440,1012,2144,5970
"C10_10001000325",763,884,3659,539,2926,592,1153,2506
"C10_1001000302",203,142,880,157,726,146,200,680
"C10_1001000407",1755,1897,9661,1511,8264,1361,2696,6965
"C10_1001000408",915,1030,5225,847,4617,809,1490,3735
"C10_1001000412",1507,1605,7652,1305,7996,1181,2140,5512
"C10_B000580",10973,11725,55580,9562,52176,8528,17112,38468
"C10_B000863",258,249,1298,201,1424,212,389,909
"C10_B001007",578,491,2078,479,1969,492,647,1431
"C10_B001470",1616,1588,7821,1427,5985,1200,2132,5689
"C10_B001475",645,574,2882,603,2740,460,772,2110
"C10_B001545",891,771,4559,841,4387,638,1051,3508
"C10_B001548",2568,2315,13593,2278,10669,1800,3412,10181
"C10_B001551",1106,965,5293,1074,6119,802,1319,3974
"C10_B001554",1454,1316,7888,1315,6942,1059,2177,5711
"C10_B001556",1136,1132,6013,1062,4743,853,1600,4413
"C10_B001557",319,275,1362,325,2034,254,336,1026
"C10_B001558",390,420,2154,405,2104,371,598,1556
"C10_B002572",2805,2811,16888,2560,11568,1972,4529,12359
"C10_B002573",310,244,1919,304,906,185,488,1431
"C10_B003070",1080,941,6108,970,5525,782,1608,4500
"C10_B003113",1010,594,2130,439,2007,445,702,1428
"C10_B003115",467,505,2134,395,1759,384,561,1573
"C10_B003119",1649,1425,7911,1490,7314,1187,2065,5846
"C10_B003518",1533,1576,8011,1610,8425,1225,2155,5856
"C10_B003523",340,326,1662,331,1613,256,449,1213
"C10_B003527",1944,1672,9429,1668,8442,1320,2522,6907
"C11_10001000325",173,207,841,132,736,117,273,568
"C11_1001000327",685,644,2760,593,3346,587,804,1956
"C11_1001000407",1655,1768,8657,1339,7650,1256,2464,6193
"C11_1001000408",1206,1229,6001,1015,5727,906,1726,4275
"C11_1001000412",931,1017,5185,770,4608,693,1550,3635
"C11_B000420",1541,1244,7821,1478,7695,1093,1999,5822
"C11_B000862",270,344,1131,251,872,210,296,835
"C11_B000863",1623,1208,7713,1203,5751,854,1895,5818
"C11_B001007",443,381,1504,415,1397,363,430,1074
"C11_B001470",2386,2438,12459,2505,9921,2011,3344,9115
"C11_B001474",1057,932,4543,958,3511,736,1228,3315
"C11_B001548",747,587,3187,608,3195,472,769,2418
"C11_B001554",1119,885,5853,997,5005,796,1517,4336
"C11_B001556",2018,1905,10553,1833,8839,1543,2788,7765
"C11_B001558",291,281,1339,296,1510,295,347,992
"C11_B002572",599,499,3326,580,2179,409,850,2476
"C11_B002573",374,265,2043,331,959,199,453,1590
"C11_B003070",421,415,2568,424,2047,300,631,1937
"C11_B003071",671,637,3970,635,4109,539,976,2994
"C11_B003080",277,238,1207,208,938,231,353,854
"C11_B003113",442,366,2221,410,1669,319,559,1662
"C11_B003129",342,323,1411,304,1252,277,426,985
"C11_B003527",486,447,2107,375,2400,336,552,1555
"C11_B003528",1452,1199,7316,1214,4749,884,1799,5517
"C11_B003529",2317,2105,11355,2176,8426,1695,3009,8346
"C11_B003577",674,579,2731,582,2277,410,693,2038
"C11_B003588",1746,1403,8778,1497,7439,1134,2248,6530
"C12_10001000325",820,933,4152,637,3533,657,1246,2906
"C12_1001000340",1211,1226,5304,1174,5461,939,1396,3908
"C12_1001000407",1757,1907,9956,1550,8499,1438,2790,7166
"C12_1001000408",1380,1505,7333,1222,7091,1099,2118,5215
"C12_1001000412",1317,1344,6719,1007,6120,973,1947,4772
"C12_B001008",1319,1120,6630,1137,5177,930,1607,5023
"C12_B001016",985,902,5488,910,3776,664,1367,4121
"C12_B002078",1856,1632,9366,1661,7411,1290,2327,7039
"C12_B002572",2214,2127,14947,2323,9428,1711,3586,11361
"C12_B003067",1283,1146,7650,1303,6989,964,1929,5721
"C12_B003071",824,838,4735,741,4936,600,1330,3405
"C12_B003103",3891,4356,19397,3728,17289,3235,5634,13763
"C12_B003105",414,461,2646,431,1590,302,648,1998
"C12_B003116",2963,3129,13685,2822,12815,2354,3815,9870
"C12_B003129",733,732,3453,740,3219,554,919,2534
"C12_B003527",1661,1507,8816,1546,8380,1114,2283,6533
"C12_B003528",676,551,4143,738,2573,516,1015,3128
"C12_B003771",395,274,2432,293,829,172,614,1818
"C12_B003894",2573,2691,12098,2357,10774,1960,3538,8560
"C12_B003920",2785,2885,13670,2641,12548,2130,3805,9865
"C12_B003930",316,271,1579,283,813,175,351,1228
"C12_B003995",237,153,817,132,343,78,224,593
"C13_1001000407",1648,1704,8706,1455,8270,1301,2440,6266
"C13_1001000408",932,1154,5095,863,4899,767,1488,3607
"C13_1001000412",1452,1581,7636,1198,7473,1118,2242,5394
"C13_B000422",1433,1164,6939,1248,4113,921,1740,5199
"C13_B001010",1602,1400,8571,1580,6667,1196,2090,6481
"C13_B001016",767,592,3863,617,2640,502,922,2941
"C13_B002073",46,54,233,38,128,31,47,186
"C13_B002077",328,317,1487,340,1583,259,367,1120
"C13_B002572",2832,2770,17423,2713,12752,1958,4463,12960
"C13_B003070",946,840,5635,893,4667,655,1469,4166
"C13_B003103",3266,3359,15453,3097,12915,2514,4184,11269
"C13_B003105",272,309,1856,247,906,209,430,1426
"C13_B003112",2405,2206,11478,2229,10790,1780,3079,8399
"C13_B003116",2284,2344,10806,2182,10284,1783,3098,7708
"C13_B003129",241,239,1043,221,901,174,295,748
"C13_B003518",1394,1273,6653,1305,5684,981,1827,4826
"C13_B003522",718,732,3777,736,4898,633,1022,2755
"C13_B003527",1672,1432,8359,1523,7313,1063,2274,6085
"C13_B003528",380,387,1966,418,1517,311,467,1499
"C13_B003771",3609,3663,18956,3615,17508,2841,5063,13893
"C13_B003775",380,319,2493,333,1236,264,577,1916
"C13_B003894",1704,1685,7521,1574,7241,1284,2128,5393
"C13_B003920",3298,3598,15749,3026,14623,2639,4641,11108
"C13_B003930",3753,3969,18179,3453,15082,2787,5207,12972
"C14_1001000339",759,654,2640,769,3638,612,704,1936
"C14_1001000407",1402,1495,7460,1107,6462,1027,2146,5314
"C14_1001000408",1107,1168,5788,909,5525,791,1687,4101
"C14_1001000412",758,802,3677,781,5506,619,977,2700
"C14_B000420",2085,1728,10038,1782,8296,1411,2466,7572
"C14_B000422",654,595,3388,669,2218,469,819,2569
"C14_B001008",944,863,5103,877,4083,673,1183,3920
"C14_B001010",1727,1451,8722,1550,7830,1195,2187,6535
"C14_B001554",996,977,4838,969,4476,763,1351,3487
"C14_B001557",475,455,2423,490,2354,340,581,1842
"C14_B002074",224,205,1000,172,528,143,227,773
"C14_B002077",1474,1611,7304,1465,8202,1188,1983,5321
"C14_B002078",96,62,393,81,303,51,102,291
"C14_B002079",2385,2077,16541,2169,10089,1687,3829,12712
"C14_B002572",3033,2861,19642,2784,12509,2172,5032,14610
"C14_B003070",1667,1588,9211,1606,10375,1354,2307,6904
"C14_B003071",1057,914,5724,984,6170,785,1381,4343
"C14_B003103",6045,6907,28300,5334,26226,4920,8176,20124
"C14_B003116",1728,1632,7329,1594,6270,1268,2050,5279
"C14_B003129",1665,1596,8094,1533,6106,1202,2264,5830
"C14_B003132",1011,640,4810,740,2627,519,1213,3597
"C14_B003191",237,237,1103,254,754,171,287,816
"C14_B003518",1437,1400,7496,1397,6366,1088,1960,5536
"C14_B003527",1456,1208,6469,1121,6146,826,1720,4749
"C14_B003528",1075,908,6007,1016,4165,727,1452,4555
"C14_B003588",896,765,4202,793,4424,581,1072,3130
"C14_B003771",1436,1135,7331,1318,5399,907,1824,5507
"C14_B003776",2442,2612,12637,2394,11150,1831,3452,9185
"C14_B003777",453,463,2097,451,2097,363,622,1475
"C14_B003894",3839,4391,17915,3503,19382,3193,5387,12528
"C14_B003920",3214,3370,15565,2896,13005,2405,4488,11077
"C14_B003930",3274,3567,15407,3102,13742,2597,4439,10968
"C14_B003995",894,745,4212,787,4316,570,1035,3177
"C15_1001000339",1132,1023,4279,1099,5058,863,1104,3175
"C15_1001000407",1891,2040,10150,1679,9742,1446,2865,7285
"C15_1001000412",1621,1849,8636,1390,8682,1288,2522,6114
"C15_B000420",379,304,1470,363,3032,297,379,1091
"C15_B000422",2937,3145,13719,2927,13961,2587,3812,9907
"C15_B001010",1089,1042,6183,1138,4511,747,1648,4535
"C15_B002073",1379,1294,8146,1227,6228,953,2174,5972
"C15_B002074",460,542,2154,427,2325,395,638,1516
"C15_B002077",807,577,3553,701,4714,486,850,2703
"C15_B002078",700,611,2997,606,3104,461,715,2282
"C15_B002079",5211,5080,27893,4763,23696,3858,7668,20225
"C15_B002572",2275,2276,14551,2336,9779,1707,3690,10861
"C15_B003067",278,216,1630,248,1297,180,389,1241
"C15_B003103",3487,3618,15735,3228,13946,2553,4459,11276
"C15_B003105",131,108,680,99,344,91,166,514
"C15_B003112",2095,2198,11152,1934,8435,1538,3115,8037
"C15_B003116",1019,919,4143,935,4026,773,1149,2994
"C15_B003120",393,271,1981,302,1177,217,450,1531
"C15_B003125",141,119,700,113,384,61,171,529
"C15_B003126",345,237,1420,240,1516,185,350,1070
"C15_B003129",1321,1214,5828,1244,4786,1025,1600,4228
"C15_B003187",754,686,3124,630,2416,479,844,2280
"C15_B003191",1447,1362,7439,1271,4830,987,2039,5400
"C15_B003518",185,183,1063,174,440,135,283,780
"C15_B003527",1873,1691,9750,1582,7449,1228,2532,7218
"C15_B003528",775,611,3887,695,2795,540,917,2970
"C15_B003588",298,194,1094,194,997,136,294,800
"C15_B003771",3325,3249,16332,3074,14811,2346,4259,12073
"C15_B003775",846,728,4616,681,3269,549,1064,3552
"C15_B003776",1313,1151,6306,1220,5429,938,1596,4710
"C15_B003777",4224,4432,20913,3889,17342,3214,5893,15020
"C15_B003920",895,878,4246,881,4451,645,1123,3123
"C15_B003995",307,255,1437,241,1148,189,370,1067
"C16_1001000407",2106,2216,10921,1855,9703,1574,3079,7842
"C16_1001000408",1288,1418,6584,1069,6570,956,1888,4696
"C16_1001000411",1125,1178,5979,916,5365,851,1759,4220
"C16_1001000412",1476,1518,7343,1207,7332,1151,2105,5238
"C16_B000420",849,808,3787,733,3675,692,976,2811
"C16_B000422",1331,1285,6380,1300,5321,976,1741,4639
"C16_B001008",1037,812,5366,916,4107,706,1318,4048
"C16_B002073",810,650,4698,663,3530,535,1266,3432
"C16_B002074",1100,1186,5257,968,4666,774,1453,3804
"C16_B002077",2339,2512,11504,2172,11040,1816,3242,8262
"C16_B002078",1128,1053,5703,1053,5145,769,1480,4223
"C16_B002079",2171,1942,10787,1972,11569,1585,2938,7849
"C16_B002097",455,454,3012,439,2623,339,754,2258
"C16_B002572",3267,3236,21038,3231,13765,2427,5482,15556
"C16_B003071",924,865,5284,822,4524,666,1363,3921
"C16_B003103",5163,5422,24440,4658,21639,3752,6918,17522
"C16_B003105",63,62,335,49,177,40,77,258
"C16_B003112",1028,1121,5240,991,4733,820,1473,3767
"C16_B003116",2665,2728,11983,2524,10823,2093,3324,8659
"C16_B003120",1680,1103,8197,1321,5584,973,1928,6269
"C16_B003125",386,304,2124,325,1198,225,476,1648
"C16_B003126",350,289,1743,279,1836,212,480,1263
"C16_B003129",1000,851,4119,859,3653,667,1051,3068
"C16_B003132",1164,920,6165,1069,3779,735,1550,4615
"C16_B003191",119,88,544,92,291,60,134,410
"C16_B003518",2372,2394,12124,2355,10431,1822,3371,8753
"C16_B003527",1403,1017,6492,955,4235,762,1667,4825
"C16_B003528",1437,1015,7326,1094,4598,820,1790,5536
"C16_B003588",1508,1169,6992,1183,6090,874,1777,5215
"C16_B003654",2067,1673,10924,1768,8358,1458,2643,8281
"C16_B003656",339,251,1447,261,1245,198,393,1054
"C16_B003771",1359,923,5885,1047,4360,762,1442,4443
"C16_B003776",2213,2122,11512,2054,9363,1584,3018,8494
"C16_B003777",3482,3975,16514,3536,15439,2995,4894,11620
"C16_B003920",3863,4255,19422,3654,16460,3093,5627,13795
"C16_B003930",303,303,1388,246,844,201,369,1019
"C16_B003995",273,151,1215,125,470,125,317,898
"C17_1001000407",1786,1856,9846,1543,9180,1346,2791,7055
"C17_1001000408",1217,1362,6633,1036,6367,1020,1967,4666
"C17_1001000412",1307,1477,7329,1145,6978,1011,2068,5261
"C17_B000420",769,811,3455,728,3818,673,1063,2392
"C17_B000422",1177,1200,5385,1198,7638,944,1430,3955
"C17_B000577",194,185,728,133,764,163,176,552
"C17_B001007",971,839,3120,856,3008,790,876,2244
"C17_B001008",901,788,4748,748,3352,606,1195,3553
"C17_B001010",527,458,2767,480,2241,354,691,2076
"C17_B002077",2602,2518,12424,2335,12095,1925,3489,8935
"C17_B002078",57,55,221,58,145,18,46,175
"C17_B002079",764,662,3901,686,2864,502,1011,2890
"C17_B002097",1039,948,5981,876,4173,710,1609,4372
"C17_B002572",2788,2755,17855,2682,12090,2033,4588,13267
"C17_B003067",1894,1796,10556,1766,9122,1401,2735,7821
"C17_B003071",278,237,1605,210,1354,200,391,1214
"C17_B003103",3197,3303,14937,2861,13341,2361,4236,10701
"C17_B003105",381,303,2647,306,1594,219,591,2056
"C17_B003112",2002,2171,11059,1958,9011,1654,3044,8015
"C17_B003116",1778,1890,7463,1604,7835,1410,2193,5270
"C17_B003120",1012,771,5044,751,3462,568,1207,3837
"C17_B003129",295,329,1274,296,1198,244,342,932
"C17_B003518",1342,1340,6656,1217,6135,1008,1794,4862
"C17_B003522",611,589,3265,575,4889,448,852,2413
"C17_B003527",1164,1013,6610,1027,3800,706,1719,4891
"C17_B003528",436,340,2461,392,1483,246,550,1911
"C17_B003588",788,608,3740,548,2711,400,935,2805
"C17_B003654",458,337,2128,351,1558,242,557,1571
"C17_B003656",190,135,752,136,665,106,186,566
"C17_B003771",571,400,2851,475,2260,345,715,2136
"C17_B003775",1595,1171,8685,1264,5551,929,2164,6521
"C17_B003776",146,122,585,121,318,94,125,460
"C17_B003777",2581,2822,11972,2542,11027,2220,3504,8468
"C17_B003920",1483,1432,6642,1332,5690,1066,1883,4759
"C17_B003995",3666,3116,17072,3094,13806,2377,4502,12570
"C18_1001000339",1347,1310,5561,1269,5696,1014,1450,4111
"C18_1001000407",1120,1306,5838,884,5143,847,1803,4035
"C18_1001000408",1223,1247,6197,984,5469,874,1806,4391
"C18_1001000412",1557,1674,8082,1266,7957,1171,2465,5617
"C18_B000420",483,522,2092,463,3525,446,575,1517
"C18_B001007",489,415,1654,355,1592,392,495,1159
"C18_B001008",992,826,5105,927,3994,659,1235,3870
"C18_B001464",85,93,392,79,285,78,113,279
"C18_B002074",89,65,358,49,181,36,103,255
"C18_B002079",2455,1966,11550,2027,8609,1511,3035,8515
"C18_B002097",237,129,1142,127,609,112,307,835
"C18_B002572",3011,2576,13295,2323,9788,1842,3435,9860
"C18_B003067",1324,1264,7574,1243,6811,1005,2001,5573
"C18_B003079",410,265,1615,236,1599,235,465,1150
"C18_B003103",4884,5023,22517,4458,20206,3638,6338,16179
"C18_B003105",195,166,1080,212,927,155,246,834
"C18_B003112",2514,2669,12997,2478,11633,2001,3619,9378
"C18_B003116",5072,5160,22196,4499,19965,3710,6414,15782
"C18_B003129",357,359,1617,308,1434,249,420,1197
"C18_B003518",1451,1517,6905,1358,6003,1027,1808,5097
"C18_B003527",3215,2371,12632,2267,11582,1743,3387,9245
"C18_B003528",559,448,2834,521,1965,417,657,2177
"C18_B003529",401,395,1973,359,1992,359,590,1383
"C18_B003577",552,317,1967,471,1447,267,485,1482
"C18_B003654",598,464,2855,479,1948,408,713,2142
"C18_B003656",775,531,3217,457,2728,383,877,2340
"C18_B003776",756,731,3704,773,4281,603,910,2794
"C18_B003777",3976,4208,19713,3643,17380,3252,5466,14247
"C18_B003894",1414,1410,5905,1187,5630,951,1597,4308
"C18_B003920",1555,1638,7537,1478,6500,1244,2058,5479
"C18_B003930",226,193,987,170,476,112,228,759
"C19_1001000339",1077,1091,4386,970,3897,786,1103,3283
"C19_1001000340",504,475,1863,525,2538,425,498,1365
"C19_1001000407",2120,2378,11492,1932,10601,1548,3278,8214
"C19_1001000408",1012,1115,5507,838,4941,777,1612,3895
"C19_1001000412",1579,1638,8193,1275,7706,1200,2403,5790
"C19_B000420",1395,1257,5604,1257,5677,964,1497,4107
"C19_B001007",495,433,1676,451,1640,396,515,1161
"C19_B001008",653,611,3456,572,2423,471,868,2588
"C19_B001016",932,791,4962,865,3655,572,1214,3748
"C19_B002073",653,618,4104,522,3050,399,1089,3015
"C19_B002077",1417,1266,6272,1182,7011,975,1733,4539
"C19_B002078",195,135,760,176,818,127,187,573
"C19_B002079",3293,3020,16106,2925,14484,2280,4232,11874
"C19_B002097",642,573,3236,561,2671,433,829,2407
"C19_B002572",1184,1040,5894,1262,4908,1036,1546,4348
"C19_B003103",2991,2805,14562,2590,11182,2077,3858,10704
"C19_B003105",782,703,4889,715,2598,517,1169,3720
"C19_B003112",2209,2224,11639,1933,10208,1647,3106,8533
"C19_B003116",2819,3017,12844,2632,11493,2275,3656,9188
"C19_B003120",1065,795,5261,826,3303,616,1243,4018
"C19_B003129",600,534,2571,575,2194,446,747,1824
"C19_B003472",2213,1111,3779,874,3687,967,1362,2417
"C19_B003522",678,673,3561,640,3409,498,932,2629
"C19_B003527",1173,980,5920,999,5117,765,1506,4414
"C19_B003529",1275,1252,5836,1138,5627,918,1614,4222
"C19_B003654",484,387,2445,340,1460,307,658,1787
"C19_B003656",517,374,2374,383,1904,267,635,1739
"C19_B003771",605,548,2825,525,2572,416,730,2095
"C19_B003777",541,428,2625,445,1320,309,684,1941
"C19_B003920",6457,7065,31588,6084,31807,5361,9291,22297
"C19_B003930",1488,1400,6639,1338,6632,1075,1778,4861
"C19_B003995",116,93,588,74,298,40,150,438
"C2_1001000301",293,220,1125,208,981,196,282,843
"C2_1001000302",328,218,1375,245,1412,206,273,1102
"C2_1001000340",811,766,3318,867,3184,613,827,2491
"C2_1001000407",1602,1804,8698,1454,9281,1272,2460,6238
"C2_1001000408",1634,1669,7799,1323,7305,1123,2335,5464
"C2_1001000412",1612,1597,8114,1318,8159,1206,2279,5835
"C2_B000860",279,205,1261,167,641,135,319,942
"C2_B000861",197,240,820,173,901,185,293,527
"C2_B000862",1417,1094,7417,1125,5273,897,1816,5601
"C2_B000863",1140,1001,6468,985,4366,789,1695,4773
"C2_B001007",516,505,1832,413,1776,464,606,1226
"C2_B001464",971,869,5744,1109,4542,741,1338,4406
"C2_B001470",1210,1187,6228,1213,4517,892,1605,4623
"C2_B002571",124,139,534,96,332,74,140,394
"C2_B002572",2699,2184,11464,2213,9321,1785,2957,8507
"C2_B003126",147,112,720,110,428,86,183,537
"C2_B003129",1641,1796,7426,1496,6151,1250,2173,5253
"C2_B003132",590,444,2997,537,2111,416,733,2264
"C2_B003187",3481,3802,16606,3136,15284,2788,5105,11501
"C2_B003191",2949,3212,13961,2631,11882,2364,4094,9867
"C2_B003577",4104,4495,12177,2868,10533,2425,3555,8622
"C2_B003648",2100,1757,11078,1848,10327,1525,2654,8424
"C2_B003659",493,376,2209,347,1744,288,536,1673
"C20_1001000340",1367,1244,5279,1273,4900,983,1302,3977
"C20_1001000407",1432,1597,7694,1237,6774,1056,2162,5532
"C20_1001000408",1069,1182,5755,992,5148,845,1673,4082
"C20_B000420",857,783,3164,587,2879,571,881,2283
"C20_B000422",580,556,3108,574,2237,429,813,2295
"C20_B000901",694,592,2271,534,2220,521,788,1483
"C20_B001007",583,539,2041,489,1927,446,667,1374
"C20_B001008",570,467,3154,470,1741,366,771,2383
"C20_B001010",2317,2163,12597,2195,9489,1743,3200,9397
"C20_B001016",513,443,2319,466,2128,382,570,1749
"C20_B002073",1365,1131,7374,1080,5560,876,1919,5455
"C20_B002077",104,86,532,76,309,67,131,401
"C20_B002078",666,614,3540,607,3135,447,895,2645
"C20_B002079",1565,1412,7339,1454,6978,1147,1934,5405
"C20_B002097",415,368,2132,305,1647,274,546,1586
"C20_B003103",1932,1888,9108,1757,8144,1410,2350,6758
"C20_B003105",276,278,1654,226,787,171,371,1283
"C20_B003112",1448,1312,6817,1289,6392,995,1793,5024
"C20_B003116",3262,3340,14278,2960,12679,2540,4139,10139
"C20_B003120",534,408,2553,427,1803,348,637,1916
"C20_B003129",437,447,2000,437,1733,334,537,1463
"C20_B003518",1233,1046,5817,1101,4888,788,1511,4306
"C20_B003527",230,186,884,147,577,101,220,664
"C20_B003528",1155,871,6088,864,3564,684,1464,4624
"C20_B003529",1276,1148,6171,1106,4760,934,1646,4525
"C20_B003646",370,275,2027,291,1165,202,487,1540
"C20_B003654",683,664,3683,620,2669,500,983,2700
"C20_B003656",219,118,866,146,738,112,238,628
"C20_B003771",1555,1254,7518,1341,5368,915,1909,5609
"C20_B003775",800,651,3710,623,3019,525,952,2758
"C20_B003894",2975,3132,13552,2727,12165,2248,3973,9579
"C20_B003920",3145,3302,15251,2802,13494,2361,4485,10766
"C20_B003930",1810,1721,8397,1591,6202,1241,2329,6068
"C20_B003995",2375,2164,11893,1989,9435,1464,2970,8923
"C21_1001000407",1715,1849,9017,1460,8789,1231,2589,6428
"C21_1001000408",1090,1168,5912,924,5146,823,1700,4212
"C21_1001000412",1450,1501,7279,1153,6982,978,2116,5163
"C21_B000422",1398,1419,6569,1372,6413,977,1760,4809
"C21_B000901",330,276,1004,258,1078,234,356,648
"C21_B001008",771,579,3776,654,2923,451,866,2910
"C21_B001010",1576,1293,8484,1577,8506,1077,2024,6460
"C21_B001016",894,761,4727,741,3588,565,1137,3590
"C21_B002074",159,156,636,172,598,133,182,454
"C21_B002077",273,195,1086,180,522,110,278,808
"C21_B002078",145,127,688,110,412,89,183,505
"C21_B002079",757,693,3680,756,3846,585,1109,2571
"C21_B002097",352,341,2185,305,1511,210,602,1583
"C21_B002572",2182,2122,14541,1801,9186,1425,3602,10939
"C21_B003103",6654,7156,33031,5850,28363,5020,9930,23101
"C21_B003105",191,178,1302,140,560,127,320,982
"C21_B003116",2992,2947,12323,2648,11182,2077,3620,8703
"C21_B003120",1388,942,6540,1074,4676,743,1576,4964
"C21_B003129",709,634,3121,628,2318,466,872,2249
"C21_B003529",523,522,2475,414,2428,444,697,1778
"C21_B003588",1524,1308,6589,1244,7517,958,1788,4801
"C21_B003654",383,330,1643,345,1580,279,399,1244
"C21_B003656",145,75,488,87,438,67,140,348
"C21_B003771",3322,2948,16295,2706,12563,2240,4298,11997
"C21_B003776",2884,3000,14530,2685,12534,2056,3942,10588
"C21_B003920",1371,1293,5976,1151,5513,956,1677,4299
"C21_B003930",2587,2583,11538,2262,10380,1829,3199,8339
"C21_B003995",1162,838,6245,840,2965,604,1538,4707
"C22_1001000339",772,793,3375,749,2786,556,825,2550
"C22_1001000340",627,660,2514,671,3680,538,622,1892
"C22_1001000407",2109,2137,11115,1821,10365,1658,3080,8035
"C22_1001000408",1109,1194,5821,935,5279,852,1763,4058
"C22_1001000412",1516,1567,8051,1301,7620,1164,2174,5877
"C22_B000862",4434,4265,19087,3519,16911,2916,5415,13672
"C22_B000883",434,399,1450,364,1356,331,508,942
"C22_B000901",695,595,2233,527,2156,518,790,1443
"C22_B002077",77,53,454,74,214,44,123,331
"C22_B002079",4245,3980,22837,3870,17155,2962,6020,16817
"C22_B002572",2948,3099,17985,2846,12583,2130,4714,13271
"C22_B003067",1913,1998,10243,2036,12645,1793,2879,7364
"C22_B003103",2547,2355,12021,2211,10255,1661,3311,8710
"C22_B003105",630,444,4280,484,1685,333,961,3319
"C22_B003112",1367,1301,6105,1213,6277,961,1620,4485
"C22_B003116",4586,4812,20162,4128,19635,3381,6074,14088
"C22_B003120",941,684,4536,704,3129,509,1106,3430
"C22_B003126",146,102,835,124,502,79,197,638
"C22_B003129",141,139,672,118,544,95,175,497
"C22_B003132",239,203,956,163,633,146,246,710
"C22_B003187",96,65,323,82,350,60,84,239
"C22_B003191",308,259,1420,267,1007,189,363,1057
"C22_B003518",677,559,2781,497,2545,402,754,2027
"C22_B003527",1101,886,5365,873,4036,581,1421,3944
"C22_B003528",308,248,1513,312,1149,247,379,1134
"C22_B003588",407,205,1201,183,586,125,264,937
"C22_B003646",341,296,1882,337,1291,250,463,1419
"C22_B003647",2526,2307,11053,2061,11107,1760,3010,8043
"C22_B003654",360,258,1791,294,1307,225,431,1360
"C22_B003656",127,94,478,77,364,67,128,350
"C22_B003771",1927,1406,10269,1640,6981,1194,2508,7761
"C22_B003775",355,218,1174,182,954,179,293,881
"C22_B003894",774,587,3092,655,3053,455,799,2293
"C22_B003920",3268,3327,14790,3004,14588,2593,4425,10365
"C3_1001000327",601,608,2958,493,2813,517,849,2109
"C3_1001000340",426,370,1656,337,1735,276,440,1216
"C3_1001000403",3745,3497,18023,3649,17749,2838,5059,12964
"C3_1001000408",1292,1391,6683,1093,6616,980,1996,4687
"C3_B000579",4602,4469,26066,4202,21908,3459,6925,19141
"C3_B000860",362,279,1911,276,1056,218,487,1424
"C3_B000861",374,333,1404,234,1156,256,412,992
"C3_B000862",1214,1017,6634,1028,4119,821,1625,5009
"C3_B000863",1757,1436,9754,1391,8091,1074,2486,7268
"C3_B002572",174,161,818,142,465,118,191,627
"C3_B002573",193,183,1085,182,659,141,248,837
"C3_B003071",359,339,1995,382,1892,250,487,1508
"C3_B003080",720,548,3189,619,2743,464,838,2351
"C3_B003115",316,292,1338,273,1266,251,391,947
"C3_B003121",34,30,221,38,97,22,59,162
"C3_B003126",519,334,1778,267,1174,255,517,1261
"C3_B003129",1750,1509,7300,1565,4979,1217,1872,5428
"C3_B003132",377,282,1648,305,1098,240,390,1258
"C3_B003187",796,599,3331,628,1846,506,844,2487
"C3_B003191",2429,2789,11485,2330,10086,1911,3358,8127
"C3_B003648",291,227,1525,210,699,150,374,1151
"C4_10001000325",567,661,2848,428,2281,433,849,1999
"C4_1001000302",383,312,1605,352,1640,295,393,1212
"C4_1001000317",637,769,3293,524,2585,535,1017,2276
"C4_1001000407",1813,1912,9581,1593,8395,1384,2588,6993
"C4_1001000408",59,87,342,63,191,47,95,247
"C4_1001000412",1328,1403,6879,1065,6865,1008,2023,4856
"C4_B000863",210,140,1140,137,449,113,267,873
"C4_B001007",450,438,1726,454,1588,371,529,1197
"C4_B001474",762,669,4009,765,2176,562,1042,2967
"C4_B001551",785,792,3876,737,3907,619,1087,2789
"C4_B001554",249,274,1316,171,959,185,408,908
"C4_B001556",1034,979,5639,942,4432,742,1408,4231
"C4_B001557",115,108,501,104,455,124,163,338
"C4_B001559",521,495,2355,574,2233,384,553,1802
"C4_B002572",2674,2661,16787,2494,10110,1907,4306,12481
"C4_B002573",104,82,526,71,288,54,116,410
"C4_B003071",516,488,3027,465,2504,383,785,2242
"C4_B003113",347,299,1121,286,1099,258,330,791
"C4_B003115",481,524,1908,376,1973,456,620,1288
"C4_B003126",613,530,3378,549,2266,420,844,2534
"C4_B003129",1525,1377,6585,1362,5259,1070,1759,4826
"C4_B003191",3076,3727,15551,2978,15219,2836,4649,10902
"C4_B003648",581,401,2843,530,2355,393,645,2198
"C5_1001000302",305,238,1680,297,1545,268,376,1304
"C5_1001000317",473,557,2329,365,1653,348,662,1667
"C5_1001000327",726,792,3398,578,2746,538,975,2423
"C5_1001000407",1924,2148,10889,1682,9387,1443,3054,7835
"C5_1001000408",1339,1408,7132,1198,6751,1034,1993,5139
"C5_B000860",134,116,808,112,389,75,200,608
"C5_B000862",5904,6251,26194,5903,29926,5228,7391,18803
"C5_B000863",903,727,4690,665,2388,473,1203,3487
"C5_B001007",603,529,2177,557,2139,518,726,1451
"C5_B001464",425,389,2475,377,1302,273,640,1835
"C5_B001470",764,660,3736,708,2733,555,936,2800
"C5_B001545",787,744,4407,807,3362,609,1100,3307
"C5_B001548",429,390,2753,408,2051,293,708,2045
"C5_B001551",1009,933,4768,933,4525,771,1383,3385
"C5_B001554",458,530,2550,363,2320,351,763,1787
"C5_B001557",920,847,4434,926,4294,744,1099,3335
"C5_B001559",1164,1040,5225,1090,5762,910,1341,3884
"C5_B002571",766,752,4980,799,3162,591,1214,3766
"C5_B002572",809,784,5626,725,2541,559,1508,4118
"C5_B002573",1417,1355,7552,1298,6192,991,1951,5601
"C5_B003070",401,362,2122,380,1936,291,552,1570
"C5_B003071",214,206,979,182,1420,172,245,734
"C5_B003113",525,377,1496,364,1329,326,435,1061
"C5_B003125",763,611,2354,560,2477,525,758,1596
"C5_B003126",581,474,3046,516,2661,398,775,2271
"C5_B003129",1230,1250,6084,1211,4993,1047,1569,4515
"C5_B003132",1236,1063,6077,1054,3738,795,1501,4576
"C5_B003187",1238,1089,4918,1107,3800,775,1339,3579
"C5_B003191",1721,1928,8600,1685,7142,1501,2511,6089
"C5_B003647",2980,2643,15324,2755,12538,2137,3930,11394
"C5_B003648",130,119,718,147,721,106,207,511
"C6_1001000302",265,285,1236,224,1154,251,298,938
"C6_1001000317",878,1034,4210,599,3140,666,1291,2919
"C6_1001000408",845,899,4457,684,4166,631,1372,3085
"C6_1001000412",1785,1896,9699,1609,9883,1379,2710,6989
"C6_B000862",6004,6556,28404,5615,30180,4843,8221,20183
"C6_B000863",533,430,3282,388,1757,274,782,2500
"C6_B001464",1198,1061,7054,1214,4845,889,1755,5299
"C6_B001475",108,111,456,89,349,97,143,313
"C6_B001545",1606,1452,9828,1475,5808,1196,2290,7538
"C6_B001548",473,441,2123,425,2438,391,611,1512
"C6_B001551",146,147,562,131,504,146,184,378
"C6_B001554",647,615,3463,569,4680,459,904,2559
"C6_B001556",1891,1544,9911,1626,7461,1228,2488,7423
"C6_B002573",1094,987,5914,1016,4183,747,1521,4393
"C6_B003113",386,312,1373,315,1102,271,389,984
"C6_B003115",93,71,399,66,273,46,99,300
"C6_B003125",901,799,3172,731,2976,659,980,2192
"C6_B003126",50,61,305,46,207,36,81,224
"C6_B003129",271,288,1199,235,854,184,305,894
"C6_B003132",1456,1055,7173,1217,3927,935,1666,5507
"C6_B003187",1975,2043,8957,1799,8505,1580,2656,6301
"C6_B003191",297,235,1272,243,632,181,335,937
"C6_B003527",2165,1822,10341,1768,10006,1366,2778,7563
"C6_B003528",34,42,145,36,119,28,28,117
"C6_B003648",1500,1098,7629,1192,5409,814,1839,5790
"C6_B003659",266,214,1316,170,994,139,360,956
"C7_1001000301",313,261,1478,253,1421,271,391,1087
"C7_1001000317",536,601,2462,416,2137,443,761,1701
"C7_1001000407",631,682,3506,460,2809,472,1014,2492
"C7_1001000408",937,1078,5058,788,4905,804,1534,3524
"C7_1001000412",1703,1824,9322,1580,8963,1364,2691,6631
"C7_B001007",430,412,1661,382,1731,395,564,1097
"C7_B001470",867,711,4113,903,3301,621,960,3153
"C7_B001475",304,265,1188,270,1203,232,358,830
"C7_B001548",494,445,2192,467,2870,375,588,1604
"C7_B001554",526,520,2914,462,2782,410,742,2172
"C7_B001556",748,664,3710,694,3868,560,1032,2678
"C7_B001558",764,780,4038,787,3608,629,1072,2966
"C7_B002571",777,646,4343,730,2711,499,1060,3283
"C7_B002573",658,664,3732,689,3395,575,953,2779
"C7_B003113",368,269,1057,251,1060,270,327,730
"C7_B003119",2749,2393,13949,2279,10172,1762,3686,10263
"C7_B003125",1181,1101,4780,1018,4287,867,1436,3344
"C7_B003126",348,273,1891,313,1806,190,443,1448
"C7_B003129",726,591,2803,665,2119,505,691,2112
"C7_B003132",510,365,2730,412,1149,299,677,2053
"C7_B003191",1200,1211,5686,1102,4240,943,1498,4188
"C7_B003518",640,631,2858,561,3013,450,729,2129
"C7_B003523",3332,3152,16183,2882,12272,2329,4408,11775
"C7_B003527",2032,1226,8185,1399,7431,1062,2108,6077
"C7_B003528",1933,1710,10018,1713,6130,1338,2499,7519
"C7_B003648",2250,1764,12207,1969,10201,1440,2952,9255
"C8_1001000340",1040,1008,4428,940,4179,718,1101,3327
"C8_1001000407",1545,1743,8446,1405,7229,1178,2388,6058
"C8_1001000408",1245,1357,6292,1053,6293,1008,1852,4440
"C8_1001000412",1629,1780,8917,1459,8081,1323,2526,6391
"C8_B000862",5986,5985,26322,5975,29014,5107,7425,18897
"C8_B000863",1247,975,7209,949,4580,715,1827,5382
"C8_B001470",1120,1060,5744,1137,4528,837,1424,4320
"C8_B001543",329,227,1761,317,1617,200,420,1341
"C8_B001548",911,908,3893,899,4963,705,1044,2849
"C8_B001551",1048,1175,5453,1110,5408,885,1480,3973
"C8_B001556",1979,1841,10509,1784,8336,1498,2768,7741
"C8_B001558",1619,1597,9442,1535,7768,1254,2395,7047
"C8_B002571",499,428,2422,597,2198,418,526,1896
"C8_B002572",1546,1337,8179,1505,6028,1134,2117,6062
"C8_B002573",1383,1477,7515,1372,6558,1218,1915,5600
"C8_B003067",751,660,3991,755,4244,554,1020,2971
"C8_B003070",1328,1212,7691,1285,7467,931,1945,5746
"C8_B003113",194,163,742,153,547,146,216,526
"C8_B003119",572,459,2357,515,2679,394,565,1792
"C8_B003125",743,705,2691,606,3043,647,821,1870
"C8_B003126",266,204,1502,233,1419,164,394,1108
"C8_B003129",233,199,1036,210,782,155,286,750
"C8_B003191",1339,1334,6447,1205,4720,1051,1752,4695
"C8_B003518",1808,1827,9314,1665,8416,1405,2512,6802
"C8_B003523",3254,3240,16207,2802,12432,2321,4415,11792
"C8_B003527",458,344,2268,389,1437,320,538,1730
"C8_B003528",1387,1287,8141,1353,5048,1050,2105,6036
"C8_B003577",1493,1214,6491,1293,4654,920,1548,4943
"C8_B003659",875,827,4103,731,3161,606,1075,3028
"C9_1001000301",264,277,1176,242,1103,222,345,831
"C9_1001000317",791,890,3771,548,3172,634,1179,2592
"C9_1001000340",802,736,2733,795,3411,736,723,2010
"C9_1001000407",1694,1760,9070,1490,8095,1255,2603,6467
"C9_1001000408",1224,1290,6203,1036,5885,885,1823,4380
"C9_1001000412",1267,1367,6623,1023,6183,944,1920,4703
"C9_B000860",213,152,934,146,525,107,236,698
"C9_B000861",452,344,2288,354,1662,268,586,1702
"C9_B000863",1602,1225,8385,1210,6206,939,1959,6426
"C9_B001007",414,341,1431,307,1421,340,448,983
"C9_B001470",1932,1850,9248,1911,7890,1572,2550,6698
"C9_B001475",375,373,1769,336,1380,286,470,1299
"C9_B001545",522,453,2571,593,2639,442,627,1944
"C9_B001548",652,660,3085,631,3229,542,784,2301
"C9_B001551",1339,1313,6741,1286,6562,1000,1715,5026
"C9_B001557",714,650,3909,714,3468,595,872,3037
"C9_B001558",482,457,2582,483,3849,392,610,1972
"C9_B002572",2279,2158,11672,2222,9590,1732,3130,8542
"C9_B002573",745,639,4054,704,2651,498,1024,3030
"C9_B003067",416,384,2185,335,1733,284,591,1594
"C9_B003113",738,531,2136,538,1988,489,608,1528
"C9_B003115",549,470,2141,414,1735,366,563,1578
"C9_B003119",990,896,4590,870,3952,629,1157,3433
"C9_B003518",2508,2749,13094,2469,12140,1962,3526,9568
"C9_B003522",638,631,3787,604,2479,457,932,2855
"C9_B003523",1840,1683,9333,1741,6576,1243,2335,6998
"C9_B003527",1702,1481,9089,1461,7830,1084,2322,6767
"C9_B003528",1652,1460,7604,1236,5535,1047,1898,5706
"C9_B003529",208,213,960,173,788,154,290,670
"C9_B003588",361,268,1608,247,1030,162,418,1190
"C9_B003995",3759,3318,19351,3439,15079,2493,5180,14171
"D1_1001000317",598,656,2828,478,2833,498,819,2009
"D1_1001000327",135,169,543,98,471,101,166,377
"D1_1001000407",1731,1933,8714,1462,8940,1410,2469,6245
"D1_1001000408",1240,1315,6268,938,6252,884,1782,4486
"D1_B000280",671,552,2862,528,2391,467,759,2103
"D1_B001007",605,543,2181,507,1975,491,692,1489
"D1_B001464",664,637,3620,650,2447,474,933,2687
"D1_B001470",1745,1609,8799,1712,6124,1253,2233,6566
"D1_B001543",568,474,3611,559,2237,332,899,2712
"D1_B001558",1213,1193,7220,1221,4726,993,1870,5350
"D1_B001625",63,59,402,56,239,43,119,283
"D1_B002568",110,130,485,103,553,108,148,337
"D1_B002571",565,530,2752,577,2861,492,748,2004
"D1_B002572",2849,2832,18080,2716,11695,1998,4680,13400
"D1_B003068",79,79,459,78,309,65,142,317
"D1_B003071",629,634,3918,566,3268,494,1039,2879
"D1_B003115",296,303,1361,315,1355,250,366,995
"D1_B003121",373,293,1834,380,1219,278,450,1384
"D1_B003132",810,643,4115,862,2652,576,1006,3109
"D1_B003187",355,255,1349,266,906,199,339,1010
"D1_B003191",602,590,2784,572,1779,427,650,2134
"D1_B003659",501,387,2271,423,1719,308,546,1725
"D1_B003995",164,148,773,121,429,81,225,548
"D10_1001000302",240,167,1080,204,912,179,211,869
"D10_1001000327",137,166,585,148,561,122,162,423
"D10_1001000407",1584,1786,8525,1282,7092,1176,2369,6156
"D10_1001000408",1389,1504,7139,1192,6855,1059,1987,5152
"D10_1001000412",1675,1789,9191,1486,8991,1366,2562,6629
"D10_B000573",1276,967,6153,1062,4603,862,1610,4543
"D10_B000860",298,241,1646,178,856,158,400,1246
"D10_B000862",7131,7368,31561,6056,33096,5390,9284,22277
"D10_B001016",259,238,1216,246,1137,200,318,898
"D10_B001474",3078,3126,14500,3048,12734,2402,3904,10596
"D10_B001475",1518,1319,7500,1339,4898,1026,1956,5544
"D10_B001545",919,820,4695,962,4336,693,1053,3642
"D10_B001548",803,774,4114,810,3777,564,1026,3088
"D10_B001554",1311,1202,6992,1302,6084,1020,1906,5086
"D10_B001556",259,243,1582,237,1589,187,383,1199
"D10_B001558",730,718,4058,769,4064,583,1030,3028
"D10_B002572",2606,2581,16292,2499,11800,1866,4168,12124
"D10_B002573",264,210,1673,249,901,163,443,1230
"D10_B003093",745,761,3918,782,2523,595,975,2943
"D10_B003115",253,199,1047,226,954,241,281,766
"D10_B003119",1239,1055,6135,1058,4932,789,1605,4530
"D10_B003523",6775,7477,33252,6061,30214,5705,9689,23563
"D10_B003527",2306,1993,10532,1862,9423,1458,2723,7809
"D10_B003528",2732,2306,12840,2181,9239,1852,3333,9507
"D10_B003529",3754,3909,19279,3518,15717,2971,5358,13921
"D10_B003588",298,269,1520,284,1693,203,410,1110
"D10_B003995",500,418,2268,458,2492,383,574,1694
"D11_1001000317",434,467,1745,329,1642,332,481,1264
"D11_1001000340",953,934,3795,833,3930,666,994,2801
"D11_1001000407",1303,1447,6978,1064,5903,1024,1950,5028
"D11_1001000408",1026,1157,5475,816,4549,777,1612,3863
"D11_1001000412",1613,1729,9059,1439,8579,1245,2469,6590
"D11_B000861",169,164,1030,132,572,117,244,786
"D11_B000862",395,333,2079,324,1289,243,532,1547
"D11_B001007",766,587,2482,607,2340,543,766,1716
"D11_B001016",401,392,2286,418,1702,313,527,1759
"D11_B001470",585,501,3003,603,2329,422,750,2253
"D11_B001474",3039,3019,13249,2789,12816,2384,3575,9674
"D11_B001545",727,705,4057,758,4000,575,978,3079
"D11_B002077",837,857,3871,770,3781,630,1012,2859
"D11_B002079",5742,5977,29749,5254,27941,4561,8609,21140
"D11_B002572",1046,927,5199,1049,3670,757,1347,3852
"D11_B003093",122,101,768,86,385,77,195,573
"D11_B003113",483,384,2533,375,1614,270,649,1884
"D11_B003518",313,274,1647,287,962,212,416,1231
"D11_B003527",2314,2056,11216,2049,12070,1628,3033,8183
"D11_B003528",0,1,1,1,2,0,0,1
"D11_B003588",812,766,4001,728,4073,586,1099,2902
"D12_1001000327",430,479,2180,402,2805,382,637,1543
"D12_1001000407",1620,1763,8302,1363,8161,1233,2364,5938
"D12_1001000408",1046,1149,5351,909,5373,761,1633,3718
"D12_1001000412",87,129,633,88,458,97,209,424
"D12_B000862",3471,3160,18221,3242,15902,2644,4538,13683
"D12_B001007",645,524,2155,570,2066,483,669,1486
"D12_B001474",2089,1910,9510,1966,8239,1497,2612,6898
"D12_B002572",1263,1095,6156,1233,4621,941,1697,4459
"D12_B003071",803,803,4901,788,4323,585,1282,3619
"D12_B003093",3248,3787,16263,3123,14824,2757,4800,11463
"D12_B003105",690,578,4326,614,2306,476,972,3354
"D12_B003116",2675,2937,12626,2430,10558,2084,3674,8952
"D12_B003119",228,237,1026,233,1219,165,223,803
"D12_B003120",967,660,4762,729,3114,556,1133,3629
"D12_B003518",2255,2246,11179,2033,9495,1630,2974,8205
"D12_B003527",1760,1539,8577,1538,8261,1213,2318,6259
"D12_B003528",336,234,1868,316,1396,194,478,1390
"D12_B003529",4441,4786,21822,4196,19507,3715,6235,15587
"D12_B003588",212,184,960,206,1115,169,251,709
"D12_B003771",1051,865,5539,984,4903,712,1329,4210
"D12_B003775",192,188,1058,200,1004,169,299,759
"D12_B003776",1516,1393,8122,1433,6339,1076,2085,6037
"D12_B003777",724,751,3268,721,4290,581,863,2405
"D12_B003930",3665,4052,17545,3272,15063,2889,5078,12467
"D12_B003995",229,211,1196,211,632,125,274,922
"D13_1001000340",931,925,3989,886,3881,658,969,3020
"D13_1001000407",1734,1881,9400,1495,8541,1325,2711,6689
"D13_1001000408",1065,1203,5498,901,5332,845,1663,3835
"D13_1001000412",1414,1502,7406,1263,7040,1068,2029,5377
"D13_B000420",73,74,410,61,247,35,89,321
"D13_B000422",1982,1949,9706,1895,8412,1525,2481,7225
"D13_B001007",617,563,2339,513,2230,465,663,1676
"D13_B001557",927,871,4528,985,5094,800,1255,3273
"D13_B002077",3307,3435,16942,2950,14594,2449,4853,12089
"D13_B002078",626,508,3159,580,2725,385,804,2355
"D13_B002079",558,531,2443,522,2418,451,610,1833
"D13_B002572",2842,2735,17474,2701,11707,2060,4509,12965
"D13_B003093",383,399,1748,366,1412,260,462,1286
"D13_B003103",4302,4876,20855,4014,18722,3476,6007,14848
"D13_B003105",211,196,1247,204,574,128,310,937
"D13_B003112",2774,2819,14395,2656,12386,2044,3640,10755
"D13_B003116",5816,6184,26530,5367,24179,4586,7871,18659
"D13_B003120",665,508,3181,443,2162,309,741,2440
"D13_B003518",1891,1980,9543,1852,8598,1489,2573,6970
"D13_B003527",1867,1599,9533,1579,8447,1193,2575,6958
"D13_B003771",1157,1058,5815,1013,4806,767,1515,4300
"D13_B003775",609,463,3106,579,2973,447,741,2365
"D13_B003776",381,277,2244,360,1024,246,513,1731
"D13_B003920",3706,4299,18106,3522,16093,3046,5232,12874
"D13_B003930",1946,1831,8865,1798,8306,1437,2393,6472
"D13_B003995",410,310,2037,368,1540,286,485,1552
"D14_1001000339",820,826,3527,813,2982,603,864,2663
"D14_1001000407",1795,1986,9390,1569,9201,1396,2649,6741
"D14_1001000408",1169,1269,6012,954,5544,864,1794,4218
"D14_1001000412",1563,1623,7852,1226,7731,1109,2294,5558
"D14_B000422",3399,3597,17509,3318,15314,2753,4934,12575
"D14_B001007",640,556,2529,558,2247,503,731,1798
"D14_B001008",840,586,3863,653,2715,444,909,2954
"D14_B001016",2083,1815,11271,1862,8120,1422,2824,8447
"D14_B001470",1050,896,4886,1015,3757,719,1236,3650
"D14_B002073",762,667,4512,772,4611,565,1091,3421
"D14_B002074",2275,2374,10637,1909,9316,1876,3159,7478
"D14_B002077",2602,3066,13575,2509,12920,2306,4021,9554
"D14_B002078",480,407,2244,402,2552,312,541,1703
"D14_B002097",445,435,2420,386,2021,290,640,1780
"D14_B002572",2975,2916,19032,2942,12126,2204,4798,14234
"D14_B003067",1344,1263,7685,1312,8716,1105,1938,5747
"D14_B003070",938,872,5863,853,4254,715,1546,4317
"D14_B003071",240,260,1218,306,2053,272,288,930
"D14_B003093",1188,1306,5584,1078,4717,918,1598,3986
"D14_B003103",4129,4583,20273,3838,17216,3304,5899,14374
"D14_B003105",866,829,5553,811,3097,611,1310,4243
"D14_B003112",3680,4011,19765,3780,17739,3024,5543,14222
"D14_B003116",4453,4835,20850,4189,18752,3557,6100,14750
"D14_B003125",599,521,2810,542,2504,427,718,2092
"D14_B003126",923,697,4654,748,3451,567,1208,3446
"D14_B003129",274,245,1217,263,1036,207,313,904
"D14_B003132",2407,1971,10973,1990,8474,1591,2848,8125
"D14_B003187",314,217,1238,235,966,179,283,955
"D14_B003191",479,477,2407,459,1794,375,612,1795
"D14_B003518",1806,1815,9461,1801,8850,1389,2463,6998
"D14_B003527",1341,1284,6678,1158,7862,935,1772,4906
"D14_B003528",3,4,13,7,36,5,3,10
"D14_B003529",2907,3037,14004,2815,11298,2359,3747,10257
"D14_B003588",1485,1287,7437,1227,6645,966,1980,5457
"D14_B003771",728,640,3642,697,3452,479,870,2772
"D14_B003776",4633,4975,23394,4412,22673,3646,6736,16658
"D14_B003894",2586,2983,12180,2299,12655,2166,3759,8421
"D14_B003920",3141,3313,15136,2985,13986,2465,4356,10780
"D14_B003930",3177,3308,15009,2965,13151,2415,4083,10926
"D14_B003995",2040,1731,10626,1784,7527,1272,2604,8022
"D15_1001000407",2152,2267,11158,1850,11157,1673,3130,8028
"D15_1001000408",820,842,3863,775,4958,706,1090,2773
"D15_1001000412",1588,1668,8708,1399,8012,1226,2362,6346
"D15_B000420",1765,1528,8303,1551,7139,1207,2039,6264
"D15_B000422",2684,2569,12625,2578,9821,1975,3331,9294
"D15_B001007",753,610,2779,602,2381,563,909,1870
"D15_B001008",1350,1059,6617,1180,5376,882,1614,5003
"D15_B001016",537,428,2766,501,2050,338,676,2090
"D15_B002074",1556,1598,7456,1355,6368,1202,2170,5286
"D15_B002077",982,932,4508,947,4402,766,1235,3273
"D15_B002078",1477,1380,7499,1282,6424,1030,2027,5472
"D15_B002079",2544,2391,13087,2421,11881,1858,3413,9674
"D15_B002097",1054,1024,5634,892,4276,699,1528,4106
"D15_B002572",3499,3571,23019,3296,14652,2477,5863,17156
"D15_B003071",1173,1182,7141,1181,6456,953,1918,5223
"D15_B003093",957,1007,4333,870,3585,735,1221,3112
"D15_B003097",1785,1981,9774,1732,7853,1504,2743,7031
"D15_B003103",3425,3672,15712,3300,14641,2710,4453,11259
"D15_B003105",586,550,3488,533,2246,401,857,2631
"D15_B003112",2026,2126,10730,1997,9063,1579,2965,7765
"D15_B003116",1392,1356,5826,1324,5772,1119,1534,4292
"D15_B003120",717,488,3659,597,2329,363,899,2760
"D15_B003125",952,771,4706,794,3493,582,1194,3512
"D15_B003126",1280,1126,7015,1083,4954,841,1755,5260
"D15_B003129",337,310,1477,346,1386,234,367,1110
"D15_B003132",648,397,2994,458,1717,314,752,2242
"D15_B003191",582,580,2890,601,2591,430,795,2095
"D15_B003518",1526,1438,7467,1462,6509,1143,2037,5430
"D15_B003527",2090,1818,10172,1804,9313,1360,2605,7567
"D15_B003528",831,666,4245,717,2899,598,1017,3228
"D15_B003529",2957,3103,15103,2797,11911,2376,4248,10855
"D15_B003776",2883,2804,14974,2723,12481,2170,3915,11059
"D15_B003920",3617,3880,17484,3301,15270,2772,5085,12399
"D15_B003995",1077,873,4897,998,5817,702,1193,3704
"D16_1001000339",1285,1241,5577,1080,5725,952,1516,4061
"D16_1001000407",1715,1917,9549,1527,8567,1468,2603,6946
"D16_1001000408",1128,1235,6299,952,5567,904,1826,4473
"D16_1001000412",1581,1700,8526,1453,8774,1290,2418,6108
"D16_B000420",989,878,4059,878,3708,711,1008,3051
"D16_B001008",349,292,2064,308,1512,227,492,1572
"D16_B001016",856,732,4192,756,3196,582,1049,3143
"D16_B001470",788,752,3852,830,3087,540,1010,2842
"D16_B002073",53,51,349,53,217,44,82,267
"D16_B002074",1233,1270,5744,1079,5201,950,1613,4131
"D16_B002077",1215,1207,6367,1186,6116,900,1865,4502
"D16_B002078",363,305,1860,336,2013,240,487,1373
"D16_B002079",1196,996,5457,988,5869,762,1421,4036
"D16_B002097",858,800,4664,675,3378,507,1199,3465
"D16_B002572",2543,2537,16876,2669,10824,1873,4334,12542
"D16_B003093",289,287,1591,279,1175,204,423,1168
"D16_B003097",319,289,1732,250,1106,194,411,1321
"D16_B003103",5208,5388,24458,4719,23449,3880,6989,17469
"D16_B003116",4220,4325,18540,3679,16834,3172,5279,13261
"D16_B003125",215,169,1098,165,742,116,238,860
"D16_B003126",751,619,3609,710,4458,543,919,2690
"D16_B003132",505,348,2077,432,1447,279,503,1574
"D16_B003187",549,493,2614,487,1955,406,675,1939
"D16_B003191",423,387,2178,410,1929,303,529,1649
"D16_B003518",2337,2250,11026,1968,9156,1566,2969,8057
"D16_B003522",153,128,720,132,346,107,177,543
"D16_B003527",1442,1261,7104,1234,5786,993,1818,5286
"D16_B003528",868,673,4299,737,3386,503,1038,3261
"D16_B003529",421,365,1915,413,3861,279,506,1409
"D16_B003654",956,754,4682,781,3375,656,1137,3545
"D16_B003771",1643,1268,8596,1403,6202,1012,2108,6488
"D16_B003776",2349,2330,12631,2039,10034,1682,3301,9330
"D16_B003894",1199,1176,5293,1017,5278,958,1454,3839
"D16_B003920",418,408,1838,447,1791,315,500,1338
"D16_B003930",2222,2228,10335,2079,8656,1650,2840,7495
"D17_1001000339",816,792,3230,689,2614,557,821,2409
"D17_1001000407",1897,1969,9891,1615,9478,1532,2874,7017
"D17_1001000408",1214,1303,6477,1037,6137,989,1896,4581
"D17_1001000412",1427,1515,7545,1160,6812,1007,2071,5474
"D17_B000420",139,159,462,118,462,123,119,343
"D17_B001007",707,607,2601,636,2334,536,774,1827
"D17_B001008",634,569,3393,575,2697,453,815,2578
"D17_B001016",736,616,3785,643,2474,503,898,2887
"D17_B001470",743,630,3657,705,2861,499,919,2738
"D17_B002073",750,642,3323,753,3468,590,931,2392
"D17_B002074",365,344,1803,364,1652,282,447,1356
"D17_B002077",1209,927,4541,891,5227,697,1194,3347
"D17_B002078",1490,1228,7816,1308,6733,895,1930,5886
"D17_B002079",1216,1095,5822,1183,7685,1048,1532,4290
"D17_B002097",464,420,2183,406,1754,320,558,1625
"D17_B002572",2969,2694,18671,2758,13191,2056,4746,13925
"D17_B003067",2449,2203,13259,2172,10714,1638,3466,9793
"D17_B003071",869,844,4969,799,4729,659,1289,3680
"D17_B003093",2614,2896,12264,2311,11032,2058,3675,8589
"D17_B003097",293,216,1858,225,948,161,456,1402
"D17_B003103",178,164,747,132,325,75,207,540
"D17_B003105",781,665,4843,721,2548,526,1105,3738
"D17_B003112",2852,2904,14686,2772,13182,2217,4084,10602
"D17_B003116",3039,3167,13071,2802,14231,2345,3717,9354
"D17_B003120",513,432,2565,410,1950,363,607,1958
"D17_B003518",2501,2532,12410,2430,11309,1932,3435,8975
"D17_B003527",1814,1527,8411,1544,8914,1173,2380,6031
"D17_B003528",672,503,3298,579,2554,465,810,2488
"D17_B003529",2314,2525,11527,2185,11189,1912,3185,8342
"D17_B003588",2036,1988,9552,1805,10173,1458,2729,6823
"D17_B003654",511,412,2662,401,1783,277,686,1976
"D17_B003771",1350,1080,7200,1237,5065,874,1748,5452
"D17_B003775",196,186,1120,232,1270,182,278,842
"D17_B003777",3102,3328,13767,3045,12378,2532,3880,9887
"D17_B003894",966,991,4310,851,3863,693,1177,3133
"D17_B003930",5712,6415,27200,5050,26504,4515,8149,19051
"D17_B003995",788,551,4023,676,2083,414,1011,3012
"D18_1001000407",1768,1912,9178,1559,7842,1330,2596,6582
"D18_1001000408",1165,1324,5998,890,4933,853,1772,4226
"D18_B000420",859,887,3916,896,3550,726,1054,2862
"D18_B000862",8794,8907,40465,7526,43905,6764,11675,28790
"D18_B001007",313,264,1116,249,911,221,348,768
"D18_B001010",1183,1013,6311,1157,5100,749,1608,4703
"D18_B002073",916,768,5069,831,5230,626,1231,3838
"D18_B002078",895,711,4399,800,3580,547,1090,3309
"D18_B002079",4328,4161,22404,3971,19973,3054,5935,16469
"D18_B002097",770,714,4458,637,3062,462,1157,3301
"D18_B003093",1002,1042,4800,1001,4191,839,1288,3512
"D18_B003097",981,932,5562,908,3706,651,1440,4122
"D18_B003103",2095,2206,10370,1987,8889,1595,2893,7477
"D18_B003105",595,537,3571,573,2009,435,832,2739
"D18_B003112",2820,3062,14577,2707,14175,2306,4263,10314
"D18_B003116",3977,4051,17593,3556,15895,2911,5080,12513
"D18_B003518",2389,2487,12750,2298,13443,1793,3493,9257
"D18_B003522",2480,2499,13544,2182,10391,1722,3748,9796
"D18_B003527",1190,1066,6592,1098,5126,790,1751,4841
"D18_B003528",401,338,2029,368,1834,277,487,1542
"D18_B003529",820,885,4211,923,4278,728,1178,3033
"D18_B003577",1076,915,4397,956,3288,726,1084,3313
"D18_B003588",1669,1376,7734,1427,6973,1083,2034,5700
"D18_B003654",401,306,1831,377,1673,279,446,1385
"D18_B003771",3913,3741,19579,3431,18642,2749,5265,14314
"D18_B003776",822,739,4603,703,3488,556,1142,3461
"D18_B003894",1476,1486,6972,1312,5712,1050,1936,5036
"D18_B003920",2210,2267,10325,2162,10677,1726,2884,7441
"D18_B003930",5839,6280,27929,5346,25886,4571,8116,19813
"D18_B003995",670,571,3484,618,3826,437,834,2650
"D19_1001000339",1141,1123,4510,996,4770,786,1140,3370
"D19_1001000340",1332,1238,5486,1233,5082,991,1369,4117
"D19_1001000407",1868,2027,9931,1638,9601,1425,2865,7066
"D19_1001000408",1253,1430,6646,1058,6534,970,1894,4752
"D19_1001000412",1239,1292,6660,1024,5908,908,1982,4678
"D19_B000420",967,893,3824,869,3997,658,1067,2757
"D19_B001010",1649,1639,8319,1661,10767,1319,2274,6045
"D19_B001470",600,552,3362,627,2487,429,844,2518
"D19_B002074",992,858,4682,841,3414,714,1309,3373
"D19_B002077",1141,1026,5366,984,4770,793,1500,3866
"D19_B002079",1967,1991,9719,1828,9888,1710,2854,6865
"D19_B002097",397,352,2158,329,1719,230,535,1623
"D19_B002572",3321,3255,20646,3091,13491,2402,5351,15295
"D19_B003071",198,177,787,201,705,203,195,592
"D19_B003077",1251,1076,5653,968,4637,1259,1539,4114
"D19_B003093",1779,1802,8487,1615,7059,1384,2369,6118
"D19_B003097",594,572,3004,521,2304,388,816,2188
"D19_B003103",2275,2048,10938,1934,8188,1606,2871,8067
"D19_B003105",506,466,3103,429,1680,370,758,2345
"D19_B003112",1710,1692,8713,1583,7380,1211,2375,6338
"D19_B003116",1366,1354,5790,1273,5811,968,1660,4130
"D19_B003518",1596,1657,8389,1479,7209,1188,2344,6045
"D19_B003527",1526,1377,7541,1282,6102,957,1932,5609
"D19_B003528",182,163,790,174,644,121,175,615
"D19_B003529",1237,1204,6148,1071,4277,871,1633,4515
"D19_B003588",2521,2332,11572,2148,11106,1720,3175,8397
"D19_B003654",512,423,2859,407,1749,343,717,2142
"D19_B003771",1856,1618,8838,1780,7599,1236,2178,6660
"D19_B003775",70,52,315,65,301,36,90,225
"D19_B003920",2478,2612,12428,2399,10437,1929,3510,8918
"D19_B003930",2067,2044,10881,1847,8003,1453,2818,8063
"D2_1001000301",479,271,1481,319,1590,224,419,1062
"D2_1001000302",357,317,1822,341,1584,255,394,1428
"D2_1001000411",897,943,3914,1028,3161,857,1099,2815
"D2_1001000412",1650,1644,8868,1418,8397,1262,2487,6381
"D2_B000579",3558,3718,18846,3308,18940,2891,5465,13381
"D2_B001007",541,596,2250,527,2314,489,777,1473
"D2_B001464",2362,2308,14266,2187,10201,1664,3412,10854
"D2_B001474",1925,1639,8910,1801,6599,1407,2213,6697
"D2_B001551",296,289,1334,252,1215,191,402,932
"D2_B001558",1677,1646,9791,1692,7134,1277,2589,7202
"D2_B002572",2547,2502,16840,2659,11090,1890,4239,12601
"D2_B003093",63,53,408,53,224,40,104,304
"D2_B003115",408,412,1746,346,1699,333,453,1293
"D2_B003121",549,465,2836,445,2081,353,797,2039
"D2_B003129",794,798,3778,800,2758,603,1000,2778
"D2_B003132",1231,961,6142,1070,3516,740,1523,4619
"D2_B003187",1275,1128,4669,1041,4227,845,1245,3424
"D2_B003191",2391,2744,11790,2405,10983,2066,3279,8511
"D2_B003654",528,437,2750,410,1940,360,696,2054
"D2_B003659",349,334,1895,251,1019,181,442,1453
"D2_B003995",4575,4302,27119,4192,19694,3185,7143,19976
"D20_1001000339",1379,1303,5397,1261,5782,995,1394,4003
"D20_1001000407",1185,1158,6464,1191,7390,995,1693,4771
"D20_1001000408",1351,1453,7166,1208,7105,1066,2075,5091
"D20_1001000412",1634,1688,8262,1329,8115,1240,2377,5885
"D20_B000420",314,279,1086,245,2158,202,302,784
"D20_B000422",2783,2700,13676,2631,11155,2203,3745,9931
"D20_B001007",592,502,2077,485,1979,454,605,1472
"D20_B001008",934,897,4782,932,4728,763,1060,3722
"D20_B001016",881,734,4662,778,2932,519,1181,3481
"D20_B002073",869,743,4595,695,3764,569,1245,3350
"D20_B002074",1980,1988,9221,1755,8538,1612,2717,6504
"D20_B002077",1949,1808,9175,1650,7416,1376,2567,6608
"D20_B002078",1715,1328,8244,1392,7057,1013,2129,6115
"D20_B002079",2956,2584,15739,2692,12298,2005,4087,11652
"D20_B002097",557,520,3204,453,3611,389,850,2354
"D20_B002572",2238,2137,13514,1935,8652,1469,3490,10024
"D20_B003103",4594,4556,21937,4055,18693,3297,6007,15930
"D20_B003105",121,117,787,101,358,90,170,617
"D20_B003112",794,748,3837,750,3427,604,1045,2792
"D20_B003116",2412,2282,10607,2186,9774,1753,3036,7571
"D20_B003518",2664,2766,13877,2529,14926,2043,3879,9998
"D20_B003527",1939,1612,8841,1509,6974,1099,2298,6543
"D20_B003528",567,384,2466,468,1819,355,597,1869
"D20_B003529",2069,1884,10424,1798,8200,1416,2814,7610
"D20_B003646",327,265,1487,295,1241,237,366,1121
"D20_B003654",135,111,767,133,918,90,187,580
"D20_B003771",833,664,4577,757,2583,467,1094,3483
"D20_B003775",884,779,4825,794,3143,659,1217,3608
"D20_B003776",1821,1691,9092,1750,9323,1319,2391,6701
"D20_B003777",5469,5744,26285,4895,23176,4181,7684,18601
"D20_B003894",2330,2412,10651,2206,10494,1777,3059,7592
"D20_B003920",2232,2042,10093,2021,9279,1564,2734,7359
"D20_B003930",2069,2046,9382,1863,8800,1464,2533,6849
"D20_B003995",1293,1096,6365,1045,4842,803,1625,4740
"D21_1001000339",691,601,2857,608,2255,508,712,2145
"D21_1001000340",644,645,2487,571,2848,441,641,1846
"D21_1001000408",970,1141,5356,856,4955,815,1596,3760
"D21_1001000412",2227,2422,12153,1990,12477,1741,3414,8739
"D21_B000420",503,426,1796,380,1700,363,494,1302
"D21_B000575",211,151,928,127,449,106,273,655
"D21_B000901",1106,881,3390,853,3203,865,1166,2224
"D21_B001008",1104,807,5143,870,3881,670,1233,3910
"D21_B001016",1914,1580,9190,1634,6464,1211,2300,6890
"D21_B002073",1100,1086,6568,990,5658,796,1727,4841
"D21_B002077",1064,992,5152,966,4208,755,1414,3738
"D21_B002078",1361,1125,7053,1126,5525,918,1781,5272
"D21_B002097",337,272,1599,253,1568,210,425,1174
"D21_B003093",733,745,3713,709,2823,534,986,2727
"D21_B003105",604,477,3364,478,1941,327,808,2556
"D21_B003112",2185,2089,10603,2012,9573,1565,2856,7747
"D21_B003116",2316,2213,9219,2015,8744,1546,2528,6691
"D21_B003120",858,578,3958,601,2682,421,951,3007
"D21_B003518",1388,1444,7574,1311,5871,1038,2039,5535
"D21_B003527",1588,1207,7483,1201,6126,973,1999,5484
"D21_B003528",922,757,4805,729,3683,522,1145,3660
"D21_B003529",1482,1284,6886,1189,4939,966,1832,5054
"D21_B003577",476,350,1723,377,1343,284,397,1326
"D21_B003654",507,426,2552,395,1989,301,620,1932
"D21_B003771",749,577,3370,685,3089,451,796,2574
"D21_B003894",453,341,1693,330,968,264,396,1297
"D21_B003920",2738,2847,12725,2519,11649,2116,3599,9126
"D21_B003930",678,639,2838,577,2707,426,761,2077
"D21_B003995",3364,3063,16739,2880,13096,2463,4623,12116
"D22_1001000339",697,574,2226,635,3001,497,637,1589
"D22_1001000340",1398,1363,5771,1361,6109,1080,1454,4317
"D22_1001000407",1841,1929,9906,1711,8553,1407,2664,7242
"D22_1001000408",1088,1191,5626,897,5115,851,1626,4000
"D22_1001000412",1200,1336,6543,1080,6483,922,1901,4642
"D22_B000420",120,148,534,98,429,95,148,386
"D22_B000422",1692,1582,8042,1557,7392,1150,2115,5927
"D22_B000883",505,438,1621,389,1570,417,569,1052
"D22_B001010",1300,1189,7170,1175,5843,904,1902,5268
"D22_B001016",898,731,4606,717,3691,585,1170,3436
"D22_B001460",1271,1320,6959,1256,7455,990,1693,5266
"D22_B001470",1017,911,5025,912,3606,659,1301,3724
"D22_B002073",767,629,3307,635,4370,505,868,2439
"D22_B002074",859,865,4012,680,3730,786,1225,2787
"D22_B002077",1002,901,4976,819,4077,684,1377,3599
"D22_B002078",814,578,2876,479,1703,342,693,2183
"D22_B002079",1583,1353,8159,1498,5855,1008,2051,6108
"D22_B002572",2749,2804,17688,2451,11919,1947,4461,13227
"D22_B003093",1711,1533,10142,1687,7129,1160,2561,7581
"D22_B003105",607,480,4057,511,1822,392,922,3135
"D22_B003112",2563,2644,12740,2444,11358,1956,3499,9241
"D22_B003120",1080,712,4951,750,3612,585,1126,3825
"D22_B003126",394,351,2098,367,1715,282,554,1544
"D22_B003132",489,403,2131,386,1492,285,528,1603
"D22_B003187",222,163,861,134,689,108,213,648
"D22_B003518",1452,1416,7655,1385,6462,1111,2015,5640
"D22_B003527",1616,1064,6429,1061,6433,834,1744,4685
"D22_B003529",577,545,2736,485,2593,393,731,2005
"D22_B003588",2381,2241,10263,1907,10138,1574,2904,7359
"D22_B003654",557,451,2677,474,1982,341,680,1997
"D22_B003771",694,548,3419,570,2724,446,744,2675
"D22_B003775",195,182,856,187,906,133,251,605
"D22_B003776",1925,1691,9255,1664,7639,1366,2488,6767
"D22_B003777",3590,3590,16881,3354,14612,2650,4733,12148
"D22_B003930",1436,1466,6594,1368,6920,1030,1838,4756
"D22_B003995",3006,2629,15640,2606,11475,1820,4025,11615
"D3_1001000317",355,478,1897,274,1479,298,570,1327
"D3_1001000408",1174,1267,6092,1043,6034,944,1735,4357
"D3_1001000412",1586,1794,8473,1381,7985,1273,2367,6106
"D3_B000280",153,120,778,111,587,110,204,574
"D3_B000863",2017,1602,10295,1617,8166,1162,2539,7756
"D3_B001007",449,426,1639,394,1546,378,525,1114
"D3_B001016",419,354,2190,405,1550,305,508,1682
"D3_B001464",580,514,3149,557,2064,386,745,2404
"D3_B001474",1355,1261,6365,1354,5232,1067,1738,4627
"D3_B001543",603,463,3078,492,2270,372,787,2291
"D3_B001558",653,593,3286,560,2901,473,875,2411
"D3_B001559",319,312,1741,360,1415,259,399,1342
"D3_B002572",3160,3463,15060,2995,13438,2523,4208,10852
"D3_B002573",1226,1265,6141,1199,5828,961,1625,4516
"D3_B003093",61,45,440,61,201,44,106,334
"D3_B003115",513,451,2005,450,1864,374,546,1459
"D3_B003126",335,304,1625,261,1125,242,422,1203
"D3_B003129",1521,1498,7112,1443,5517,1230,2004,5108
"D3_B003187",1788,1935,7949,1606,6837,1481,2448,5501
"D3_B003191",1258,1420,6351,1283,5105,1106,1672,4679
"D3_B003588",2411,2307,12545,2145,12854,1754,3373,9172
"D3_B003648",677,500,3656,523,2182,397,859,2797
"D3_B003659",316,240,1444,204,1100,180,372,1072
"D4_1001000317",589,693,3087,322,2075,440,1044,2043
"D4_1001000340",694,720,2840,613,2836,501,674,2166
"D4_1001000407",1699,1904,9475,1492,8453,1396,2572,6903
"D4_1001000412",1445,1606,7897,1298,7296,1126,2232,5665
"D4_B000863",114,83,589,68,349,76,146,443
"D4_B001007",549,523,2040,475,1877,529,638,1402
"D4_B001464",1306,1239,7018,1224,5933,1013,1744,5274
"D4_B001470",1028,1029,5281,1117,4960,841,1379,3902
"D4_B001474",620,571,2940,604,2364,467,787,2153
"D4_B001543",868,713,4905,763,3284,601,1221,3684
"D4_B001556",761,634,4745,732,3246,481,1221,3524
"D4_B001558",495,497,2763,564,2612,385,773,1990
"D4_B002572",4165,4286,20678,3762,18073,3185,5715,14963
"D4_B002573",1355,1299,6922,1408,6333,1066,1792,5130
"D4_B003115",282,267,1142,242,1156,267,309,833
"D4_B003126",235,193,1324,176,696,142,324,1000
"D4_B003129",920,842,4108,795,2904,644,1013,3095
"D4_B003187",1233,1356,5292,1119,4952,1052,1536,3756
"D4_B003191",1889,1998,8577,1827,8557,1513,2458,6119
"D4_B003528",39,40,162,49,153,39,42,120
"D5_1001000302",249,263,1400,268,1268,195,296,1104
"D5_1001000315",656,769,3172,485,2486,495,962,2210
"D5_1001000407",1300,1413,7114,1005,5911,970,2027,5087
"D5_1001000408",1103,1171,5711,998,5541,904,1608,4103
"D5_1001000411",950,1085,5159,733,4535,752,1529,3630
"D5_B000861",389,381,1744,284,1512,277,480,1264
"D5_B000862",546,445,2771,402,1447,330,699,2072
"D5_B000863",1338,1029,7117,931,5099,766,1765,5352
"D5_B001016",472,422,2601,475,1946,329,634,1967
"D5_B001470",1489,1313,7845,1531,5685,1038,1944,5901
"D5_B001474",1308,1123,5971,1299,4919,924,1494,4477
"D5_B001548",404,481,1957,372,2101,358,527,1430
"D5_B001551",276,286,1299,260,1637,241,367,932
"D5_B001554",731,892,3885,614,3973,534,1222,2663
"D5_B001559",1305,1236,6554,1351,6280,1062,1725,4829
"D5_B002571",159,153,917,168,574,127,230,687
"D5_B002572",2379,2193,12318,2326,9570,1823,3234,9084
"D5_B002573",1671,1438,8539,1445,6568,1140,2151,6388
"D5_B003093",119,88,775,95,468,79,171,604
"D5_B003115",414,323,1767,358,1369,320,443,1324
"D5_B003125",1067,843,3425,864,3249,803,1107,2318
"D5_B003126",141,127,668,111,717,97,162,506
"D5_B003129",1071,895,4837,944,3343,734,1239,3598
"D5_B003187",1135,975,5169,1060,3769,783,1371,3798
"D5_B003191",480,425,2146,432,1528,340,584,1562
"D5_B003518",1811,1745,8819,1705,7554,1329,2317,6502
"D5_B003523",1271,1229,6507,1160,4984,932,1628,4879
"D5_B003528",27,26,117,26,116,16,29,88
"D5_B003648",241,211,1119,219,1411,222,286,833
"D5_B003995",742,615,3942,633,3239,513,1035,2907
"D6_1001000295",387,301,1073,325,1332,263,317,756
"D6_1001000302",381,339,1407,343,1387,286,309,1098
"D6_1001000378",552,566,3132,556,2628,451,841,2291
"D6_1001000407",1720,1870,9037,1389,7986,1374,2619,6418
"D6_1001000408",51,71,270,50,210,42,78,192
"D6_1001000412",1658,1766,8518,1338,9000,1220,2508,6010
"D6_B001464",517,467,2690,576,2461,407,629,2061
"D6_B001470",604,634,3392,662,3180,526,895,2497
"D6_B001474",1813,1551,8759,1708,6522,1360,2208,6551
"D6_B001545",68,87,416,85,266,68,107,309
"D6_B001548",1485,1434,7104,1435,6319,1153,1959,5145
"D6_B001558",1665,1630,9534,1552,7048,1314,2553,6981
"D6_B002572",2172,2059,12932,2035,8503,1487,3250,9682
"D6_B003067",1058,1044,6134,1079,5382,823,1519,4615
"D6_B003070",1515,1341,8327,1491,7892,1114,2163,6164
"D6_B003077",1653,1538,7018,1266,6197,1477,1941,5077
"D6_B003093",92,75,640,79,337,57,182,458
"D6_B003113",222,197,1105,150,656,148,284,821
"D6_B003125",242,184,736,142,670,149,247,489
"D6_B003126",271,241,1405,224,1088,186,343,1062
"D6_B003129",382,298,1710,364,1083,265,400,1310
"D6_B003132",740,563,3608,628,2350,437,876,2732
"D6_B003187",1069,1035,4377,923,3326,775,1205,3172
"D6_B003191",1163,1202,5669,1148,4299,806,1511,4158
"D6_B003527",479,353,2584,408,1454,277,569,2015
"D6_B003528",0,0,0,0,0,0,0,0
"D6_B003648",758,599,3909,670,3984,522,947,2962
"D6_B003659",353,332,2013,299,1354,239,490,1523
"D6_B003995",169,103,618,117,371,84,175,443
"D7_1001000407",1283,1437,6843,995,5437,912,2002,4841
"D7_1001000408",1307,1384,6994,1078,6414,962,2017,4977
"D7_1001000412",1438,1576,8041,1266,7156,1111,2271,5770
"D7_B000863",278,271,1643,203,782,186,417,1226
"D7_B001007",601,546,2242,493,2062,466,688,1554
"D7_B001470",1903,1730,9374,1895,7803,1423,2422,6952
"D7_B001475",1264,1296,6350,1192,4438,991,1616,4734
"D7_B001545",391,359,2164,401,2070,302,538,1626
"D7_B001548",878,936,4284,820,4436,705,1165,3119
"D7_B001551",320,325,1213,246,1477,258,393,820
"D7_B001554",631,529,3275,557,3120,440,850,2425
"D7_B001558",431,403,2446,411,1713,320,662,1784
"D7_B001559",1783,1559,9475,1717,7771,1221,2269,7206
"D7_B002572",565,549,2939,594,1503,392,738,2201
"D7_B002573",1251,1121,7163,1240,5042,909,1846,5317
"D7_B003093",92,79,603,87,333,57,158,445
"D7_B003113",498,333,2431,365,1584,304,617,1814
"D7_B003115",340,317,1500,307,1269,267,390,1110
"D7_B003125",860,764,3183,687,3069,654,919,2264
"D7_B003126",216,189,1223,187,999,166,302,921
"D7_B003129",885,591,3503,763,2247,482,809,2694
"D7_B003132",843,572,3853,725,2413,515,935,2918
"D7_B003187",1685,1729,7601,1562,6491,1296,2073,5528
"D7_B003191",634,692,3022,621,2863,487,788,2234
"D7_B003518",1796,1812,9404,1766,7453,1384,2515,6889
"D7_B003528",2,1,7,2,3,1,1,6
"D7_B003577",569,437,2287,454,1792,317,541,1746
"D7_B003648",1584,1239,8415,1310,7023,971,2069,6346
"D7_B003659",408,351,1818,339,1468,288,501,1317
"D7_B003995",1238,1088,6104,1021,4436,830,1630,4474
"D8_10001000325",536,603,2249,361,1912,422,700,1549
"D8_1001000407",1715,1837,9419,1504,7821,1307,2666,6753
"D8_1001000408",633,732,3389,524,2778,461,992,2397
"D8_1001000412",1624,1672,8256,1393,8153,1233,2345,5911
"D8_B000577",562,477,2106,374,2310,423,786,1320
"D8_B000579",1518,1459,7562,1535,7894,1267,2072,5490
"D8_B000862",4425,4481,23209,3723,20221,3492,6522,16687
"D8_B001007",205,192,784,194,785,189,232,552
"D8_B001470",2053,2066,10766,2151,10066,1642,2854,7912
"D8_B001474",889,608,4391,718,2024,515,1018,3373
"D8_B001475",542,567,2247,446,2272,428,591,1656
"D8_B001545",694,679,3743,741,3377,641,930,2813
"D8_B001554",995,909,5413,954,6223,752,1366,4047
"D8_B001558",549,512,3033,507,2528,442,801,2232
"D8_B002572",3015,2996,19292,3004,12731,2139,4877,14415
"D8_B003067",723,606,3627,754,5769,619,892,2735
"D8_B003093",117,91,660,85,325,56,169,491
"D8_B003097",28,12,143,24,89,24,32,111
"D8_B003113",341,309,1761,264,1287,248,458,1303
"D8_B003115",160,136,640,130,582,115,172,468
"D8_B003125",950,880,3599,794,3315,798,1056,2543
"D8_B003126",514,455,2927,446,2227,340,760,2167
"D8_B003129",747,606,3244,656,1927,491,787,2457
"D8_B003132",961,661,4613,755,2798,553,1067,3546
"D8_B003187",837,693,3486,719,3759,592,916,2570
"D8_B003191",2773,3005,13154,2633,11144,2233,3784,9370
"D8_B003518",1640,1645,8380,1547,8637,1244,2358,6022
"D8_B003523",1456,1208,6812,1321,5462,894,1660,5152
"D8_B003527",1773,1426,8936,1470,6735,1125,2286,6650
"D8_B003528",417,292,1923,344,1096,246,451,1472
"D8_B003577",2005,1962,8368,1753,7199,1394,2316,6052
"D8_B003648",665,493,3285,490,2766,406,812,2473
"D8_B003659",1950,1490,9157,1526,9603,1191,2254,6903
"D8_B003995",2582,574,3998,591,2125,399,959,3039
"D9_1001000292",217,192,621,185,634,164,168,453
"D9_1001000302",295,244,1349,253,1331,251,284,1065
"D9_1001000340",888,848,3546,800,3343,584,870,2676
"D9_1001000407",1808,1970,10086,1584,8731,1323,2822,7264
"D9_1001000408",915,1006,5139,759,4779,719,1522,3617
"D9_1001000412",1586,1700,8721,1357,7909,1204,2394,6327
"D9_B000861",480,378,2635,371,1296,265,666,1969
"D9_B000862",87,68,494,63,205,56,101,393
"D9_B000863",200,141,833,122,406,96,211,622
"D9_B001007",594,578,2279,558,2166,470,718,1561
"D9_B001545",240,241,1238,239,1072,199,308,930
"D9_B001554",2266,2117,12309,2020,9995,1553,3223,9086
"D9_B001558",1068,979,5920,998,4544,817,1497,4423
"D9_B002572",1639,1625,9169,1411,6284,1123,2458,6711
"D9_B003080",588,463,2742,409,2145,380,735,2007
"D9_B003093",92,68,597,73,318,48,148,449
"D9_B003113",902,774,4895,741,3481,680,1219,3676
"D9_B003119",2647,2268,12502,2483,10893,1849,3296,9206
"D9_B003518",2521,2676,12712,2395,14219,2063,3490,9222
"D9_B003523",2179,1887,10868,1961,7633,1435,2667,8201
"D9_B003527",1355,1144,7022,1148,6106,927,1782,5240
"D9_B003528",0,0,0,0,7,1,0,0
"D9_B003577",686,540,2717,565,2171,432,644,2073
"D9_B003588",367,327,1841,353,2238,296,499,1342
"D9_B003658",50,41,318,31,251,33,79,239
